target,model,img,img_height,img_width,img_channels,accuracy,confidence,obj_height,obj_width,obj_height_p,obj_width_p,xmin,xmax,ymin,ymax
bicycle,yolov8l,5021039430_0cda148fd5_z.jpg,640,427,3,1,0.951889515,358,285,55.9375,66.74473068,61,346,253,611
bicycle,yolov8l,5021039430_0cda148fd5_z.jpg,640,427,3,1,0.893700123,173,111,27.03125,25.99531616,0,111,329,502
bicycle,yolov8l,5021039430_0cda148fd5_z.jpg,640,427,3,1,0.879085839,140,65,21.875,15.22248244,361,426,274,414
bicycle,yolov8l,5021039430_0cda148fd5_z.jpg,640,427,3,1,0.440760136,52,81,8.125,18.96955504,24,105,301,353
bicycle,yolov8l,9157606630_2ef852a3ee_z.jpg,640,427,3,1,0.93084234,157,227,24.53125,53.16159251,121,348,218,375
bicycle,yolov8l,18608021442_84f7dcfa5c_z.jpg,480,640,3,1,0.936515689,156,345,32.5,53.90625,98,443,224,380
bicycle,yolov8l,18608021442_84f7dcfa5c_z.jpg,480,640,3,1,0.605212331,64,114,13.33333333,17.8125,91,205,229,293
bicycle,yolov8l,18608021442_84f7dcfa5c_z.jpg,480,640,3,1,0.324687332,97,132,20.20833333,20.625,311,443,226,323
bicycle,yolov8l,159051371_77f7d02bb6_z.jpg,480,640,3,1,0.630564034,415,380,86.45833333,59.375,184,564,57,472
bicycle,yolov8l,159051371_77f7d02bb6_z.jpg,480,640,3,1,0.495657593,194,112,40.41666667,17.5,151,263,131,325
bicycle,yolov8l,3666190087_ca2fb0d709_z.jpg,480,640,3,1,0.927962959,352,516,73.33333333,80.625,84,600,36,388
bicycle,yolov8l,2788056049_b71f8998c7_z.jpg,640,480,3,1,0.896168947,95,79,14.84375,16.45833333,255,334,378,473
bicycle,yolov8l,2788056049_b71f8998c7_z.jpg,640,480,3,1,0.840141237,117,111,18.28125,23.125,368,479,469,586
bicycle,yolov8l,2788056049_b71f8998c7_z.jpg,640,480,3,1,0.751399398,62,42,9.6875,8.75,190,232,294,356
bicycle,yolov8l,2788056049_b71f8998c7_z.jpg,640,480,3,1,0.342549831,22,40,3.4375,8.333333333,432,472,120,142
bicycle,yolov8l,14652913468_5d3b2a39f1_z.jpg,480,640,3,1,0.967168927,401,533,83.54166667,83.28125,1,534,79,480
bicycle,yolov8l,3446761063_9cdc26f36c_z.jpg,426,640,3,1,0.925370038,216,343,50.70422535,53.59375,60,403,156,372
bicycle,yolov8l,9688658716_4b3e9c618c_z.jpg,427,640,3,1,0.847674489,168,379,39.3442623,59.21875,261,640,255,423
bicycle,yolov8l,9688658716_4b3e9c618c_z.jpg,427,640,3,1,0.250017703,162,163,37.93911007,25.46875,262,425,262,424
bicycle,yolov8l,7417962302_a50fc8eb6b_z.jpg,425,640,3,1,0.956047475,158,320,37.17647059,50,202,522,264,422
bicycle,yolov8l,7417962302_a50fc8eb6b_z.jpg,425,640,3,1,0.912636638,90,167,21.17647059,26.09375,53,220,193,283
bicycle,yolov8l,7417962302_a50fc8eb6b_z.jpg,425,640,3,1,0.809146523,89,36,20.94117647,5.625,0,36,190,279
bicycle,yolov8l,3685504815_c15a389bd3_z.jpg,480,640,3,1,0.964739203,233,344,48.54166667,53.75,147,491,170,403
bicycle,yolov8l,8289650934_506c73242a_z.jpg,612,612,3,1,0.961263597,435,581,71.07843137,94.93464052,16,597,108,543
bicycle,yolov8l,4625462281_7df55484bb_z.jpg,426,640,3,1,0.909089923,284,131,66.66666667,20.46875,407,538,62,346
bicycle,yolov8l,4625462281_7df55484bb_z.jpg,426,640,3,1,0.827741265,406,432,95.30516432,67.5,5,437,14,420
bicycle,yolov8l,4625462281_7df55484bb_z.jpg,426,640,3,1,0.333672494,335,96,78.63849765,15,0,96,31,366
bicycle,yolov8l,4625462281_7df55484bb_z.jpg,426,640,3,1,0.285228074,124,93,29.10798122,14.53125,547,640,299,423
bicycle,yolov8l,4625462281_7df55484bb_z.jpg,426,640,3,1,0.262579888,400,283,93.89671362,44.21875,5,288,20,420
bicycle,yolov8l,6771874127_f8f380b3cb_z.jpg,425,640,3,1,0.926560104,407,640,95.76470588,100,0,640,4,411
bicycle,yolov8l,4349979920_189df35e15_z.jpg,480,640,3,1,0.963906705,283,444,58.95833333,69.375,148,592,71,354
bicycle,yolov8l,5816846412_7b6fa97da0_z.jpg,427,640,3,1,0.953995228,409,556,95.78454333,86.875,49,605,9,418
bicycle,yolov8l,5816846412_7b6fa97da0_z.jpg,427,640,3,1,0.308185667,272,166,63.70023419,25.9375,48,214,26,298
bicycle,yolov8l,82903264_5dd277c32d_z.jpg,480,640,3,1,0.928628445,205,220,42.70833333,34.375,189,409,245,450
bicycle,yolov8l,82903264_5dd277c32d_z.jpg,480,640,3,1,0.910032511,153,159,31.875,24.84375,18,177,264,417
bicycle,yolov8l,82903264_5dd277c32d_z.jpg,480,640,3,1,0.533899665,116,97,24.16666667,15.15625,352,449,250,366
bicycle,yolov8l,82903264_5dd277c32d_z.jpg,480,640,3,1,0.425530732,73,56,15.20833333,8.75,392,448,292,365
bicycle,yolov8l,2258982401_762044a41d_z.jpg,480,640,3,1,0.930901229,223,350,46.45833333,54.6875,284,634,170,393
bicycle,yolov8l,6141562070_11880edf2e_z.jpg,425,639,3,0,0,0,0,0,0,0,0,0,0
bicycle,yolov8l,5402229494_570e48f7f9_z.jpg,427,640,3,1,0.941038787,291,319,68.1498829,49.84375,0,319,0,291
bicycle,yolov8l,5402229494_570e48f7f9_z.jpg,427,640,3,1,0.727731407,300,495,70.25761124,77.34375,81,576,110,410
bicycle,yolov8l,3715997008_28a251eba7_z.jpg,425,640,3,0,0,0,0,0,0,0,0,0,0
bicycle,yolov8l,5877730305_f5e3d13667_z.jpg,427,640,3,1,0.937603056,260,285,60.88992974,44.53125,304,589,127,387
bicycle,yolov8l,15235483580_08696e0988_z.jpg,640,427,3,1,0.646004021,337,195,52.65625,45.66744731,119,314,236,573
bicycle,yolov8l,224422461_dddd4c8e99_z.jpg,480,640,3,1,0.617669761,277,332,57.70833333,51.875,267,599,178,455
bicycle,yolov8l,224422461_dddd4c8e99_z.jpg,480,640,3,1,0.470177084,229,337,47.70833333,52.65625,54,391,226,455
bicycle,yolov8l,224422461_dddd4c8e99_z.jpg,480,640,3,1,0.367569417,310,540,64.58333333,84.375,54,594,144,454
bicycle,yolov8l,8291522231_19e1414c1b_z.jpg,612,612,3,1,0.613498449,536,550,87.58169935,89.86928105,29,579,27,563
bicycle,yolov8l,16675918410_cc9588a553_z.jpg,359,640,3,1,0.656738698,329,377,91.64345404,58.90625,116,493,13,342
bicycle,yolov8l,2746929519_3599d54cfb_z.jpg,480,640,3,1,0.912449062,167,72,34.79166667,11.25,0,72,8,175
bicycle,yolov8l,2746929519_3599d54cfb_z.jpg,480,640,3,1,0.678260446,464,550,96.66666667,85.9375,70,620,1,465
bicycle,yolov8l,2746929519_3599d54cfb_z.jpg,480,640,3,1,0.427228093,245,279,51.04166667,43.59375,287,566,220,465
bicycle,yolov8l,5708252159_5b4ac86a01_z.jpg,480,640,3,1,0.943669021,376,531,78.33333333,82.96875,91,622,103,479
bicycle,yolov8l,5708252159_5b4ac86a01_z.jpg,480,640,3,1,0.93093276,118,176,24.58333333,27.5,252,428,0,118
bicycle,yolov8l,5708252159_5b4ac86a01_z.jpg,480,640,3,1,0.35517174,155,149,32.29166667,23.28125,113,262,110,265
bicycle,yolov8l,5708252159_5b4ac86a01_z.jpg,480,640,3,1,0.269799739,152,206,31.66666667,32.1875,54,260,110,262
bicycle,yolov8l,3353007655_56889b94a7_z.jpg,480,640,3,1,0.924202085,150,81,31.25,12.65625,281,362,224,374
bicycle,yolov8l,14265143426_0770389597_z.jpg,407,640,3,0,0,0,0,0,0,0,0,0,0
bicycle,yolov8l,8651904899_c2632fe751_z.jpg,427,640,3,1,0.329626441,271,436,63.46604215,68.125,139,575,135,406
bicycle,yolov8l,1553312291_c0cae48a37_z.jpg,640,287,3,1,0.962776721,208,143,32.5,49.82578397,0,143,214,422
bicycle,yolov8l,1553312291_c0cae48a37_z.jpg,640,287,3,1,0.960089445,158,271,24.6875,94.42508711,8,279,45,203
bicycle,yolov8l,1553312291_c0cae48a37_z.jpg,640,287,3,1,0.87532562,203,109,31.71875,37.97909408,157,266,432,635
bicycle,yolov8l,9755183855_953c4f062c_z.jpg,425,640,3,1,0.594991088,119,143,28,22.34375,271,414,302,421
bicycle,yolov8l,9755183855_953c4f062c_z.jpg,425,640,3,1,0.509437263,130,188,30.58823529,29.375,226,414,291,421
bicycle,yolov8l,5971377496_abc7d794c7_z.jpg,480,640,3,1,0.960342944,262,270,54.58333333,42.1875,111,381,217,479
bicycle,yolov8l,6459633873_5effb4b6e5_z.jpg,426,640,3,1,0.963235617,310,454,72.76995305,70.9375,110,564,93,403
bicycle,yolov8l,11484364375_4180af41fc_z.jpg,427,640,3,1,0.970120847,359,558,84.07494145,87.1875,39,597,30,389
bicycle,yolov8l,8106854318_06c1cc0fc3_z.jpg,480,640,3,1,0.977469623,357,633,74.375,98.90625,2,635,60,417
bicycle,yolov8l,296513213_9681371ed9_z.jpg,426,640,3,0,0,0,0,0,0,0,0,0,0
bicycle,yolov8l,3747524_f07f508ba9_z.jpg,640,504,3,1,0.683262229,291,344,45.46875,68.25396825,75,419,210,501
bicycle,yolov8l,18068160735_6c2f214265_z.jpg,480,640,3,0,0,0,0,0,0,0,0,0,0
bicycle,yolov8l,9141188655_328b195d8d_z.jpg,427,640,3,1,0.911981463,249,139,58.31381733,21.71875,291,430,171,420
bicycle,yolov8l,21376683791_d98acff014_z.jpg,640,640,3,1,0.953539491,443,559,69.21875,87.34375,19,578,136,579
bicycle,yolov8l,3604271495_1cacccec06_z.jpg,427,640,3,0,0,0,0,0,0,0,0,0,0
bicycle,yolov8l,51712355_49c2e95899_z.jpg,427,640,3,1,0.378283441,160,332,37.470726,51.875,225,557,149,309
bicycle,yolov8l,7675033952_b3caa0dd37_z.jpg,639,480,3,1,0.954002619,271,280,42.41001565,58.33333333,0,280,314,585
bicycle,yolov8l,14757587416_892a95bf77_z.jpg,360,640,3,1,0.72436589,182,66,50.55555556,10.3125,275,341,176,358
bicycle,yolov8l,14757587416_892a95bf77_z.jpg,360,640,3,1,0.432884187,125,95,34.72222222,14.84375,413,508,234,359
bicycle,yolov8l,2179537346_d695661bbc_z.jpg,640,425,3,1,0.65221417,247,101,38.59375,23.76470588,177,278,345,592
bicycle,yolov8l,2179537346_d695661bbc_z.jpg,640,425,3,1,0.515565574,176,89,27.5,20.94117647,189,278,416,592
bicycle,yolov8l,14628257582_1ff5e98e4c_z.jpg,400,640,3,1,0.8720119,302,630,75.5,98.4375,8,638,92,394
bicycle,yolov8l,19474810921_d2f23de0fc_z.jpg,480,640,3,0,0,0,0,0,0,0,0,0,0
bicycle,yolov8l,234597792_a9f1e7e7a9_z.jpg,425,639,3,1,0.590300679,177,167,41.64705882,26.13458529,28,195,245,422
bicycle,yolov8l,234597792_a9f1e7e7a9_z.jpg,425,639,3,1,0.586976528,76,215,17.88235294,33.64632238,297,512,348,424
bicycle,yolov8l,15333662010_2f428f7e2f_z.jpg,480,640,3,1,0.941639543,177,273,36.875,42.65625,1,274,211,388
bicycle,yolov8l,15333662010_2f428f7e2f_z.jpg,480,640,3,1,0.929513574,184,184,38.33333333,28.75,400,584,211,395
bicycle,yolov8l,15333662010_2f428f7e2f_z.jpg,480,640,3,1,0.389556527,81,85,16.875,13.28125,189,274,199,280
bicycle,yolov8l,414586991_9630094229_z.jpg,516,640,3,1,0.856845975,487,450,94.37984496,70.3125,35,485,12,499
bicycle,yolov8l,414586991_9630094229_z.jpg,516,640,3,1,0.681740046,364,469,70.54263566,73.28125,151,620,42,406
bicycle,yolov8l,414586991_9630094229_z.jpg,516,640,3,1,0.5273453,190,193,36.82170543,30.15625,37,230,12,202
bicycle,yolov8l,414586991_9630094229_z.jpg,516,640,3,1,0.403942674,245,177,47.48062016,27.65625,155,332,21,266
bicycle,yolov8l,2883059364_a6ccfaf69a_z.jpg,480,640,3,1,0.894576252,306,539,63.75,84.21875,58,597,68,374
bicycle,yolov8l,4484760806_dc814d2ce2_z.jpg,640,425,3,1,0.950492024,265,339,41.40625,79.76470588,40,379,269,534
bicycle,yolov8l,6816985831_893d039421_z.jpg,425,640,3,1,0.82099545,361,623,84.94117647,97.34375,16,639,55,416
bicycle,yolov8l,14811525368_d8b774e40a_z.jpg,425,640,3,1,0.812804401,169,87,39.76470588,13.59375,316,403,208,377
bicycle,yolov8l,14811525368_d8b774e40a_z.jpg,425,640,3,1,0.484026164,96,48,22.58823529,7.5,284,332,184,280
bicycle,yolov8l,5599702283_8562638984_z.jpg,427,640,3,1,0.944379508,381,530,89.22716628,82.8125,48,578,1,382
bicycle,yolov8l,6076857457_7a06e6ab35_z.jpg,478,640,3,1,0.880438983,140,113,29.28870293,17.65625,514,627,104,244
bicycle,yolov8l,6076857457_7a06e6ab35_z.jpg,478,640,3,1,0.713606715,400,393,83.68200837,61.40625,116,509,45,445
bicycle,yolov8l,1511658057_17b7bac11a_z.jpg,398,640,3,1,0.739251137,103,144,25.87939698,22.5,181,325,148,251
bicycle,yolov8l,1511658057_17b7bac11a_z.jpg,398,640,3,1,0.491124332,168,188,42.21105528,29.375,3,191,185,353
bicycle,yolov8l,4065552857_98aa8a39d4_z.jpg,427,640,3,1,0.860422015,108,65,25.29274005,10.15625,220,285,205,313
bicycle,yolov8l,4065552857_98aa8a39d4_z.jpg,427,640,3,1,0.845363438,112,194,26.2295082,30.3125,263,457,312,424
bicycle,yolov8l,4065552857_98aa8a39d4_z.jpg,427,640,3,1,0.748046219,62,121,14.51990632,18.90625,519,640,230,292
bicycle,yolov8l,4065552857_98aa8a39d4_z.jpg,427,640,3,1,0.7190696,210,107,49.18032787,16.71875,42,149,184,394
bicycle,yolov8l,9444094315_ba610ed94a_z.jpg,640,441,3,1,0.925436795,325,178,50.78125,40.36281179,179,357,211,536
bicycle,yolov8l,16679943419_b0fd9b6858_z.jpg,427,640,3,1,0.90862,157,131,36.76814988,20.46875,509,640,242,399
bicycle,yolov8l,16679943419_b0fd9b6858_z.jpg,427,640,3,1,0.888813555,189,116,44.26229508,18.125,524,640,2,191
bicycle,yolov8l,16679943419_b0fd9b6858_z.jpg,427,640,3,1,0.866237998,160,174,37.470726,27.1875,465,639,188,348
bicycle,yolov8l,16679943419_b0fd9b6858_z.jpg,427,640,3,1,0.812382519,145,118,33.95784543,18.4375,1,119,5,150
bicycle,yolov8l,16679943419_b0fd9b6858_z.jpg,427,640,3,1,0.804012358,167,56,39.11007026,8.75,0,56,17,184
bicycle,yolov8l,16679943419_b0fd9b6858_z.jpg,427,640,3,1,0.796630919,158,149,37.00234192,23.28125,490,639,1,159
bicycle,yolov8l,16679943419_b0fd9b6858_z.jpg,427,640,3,1,0.788486063,129,121,30.21077283,18.90625,437,558,186,315
bicycle,yolov8l,16679943419_b0fd9b6858_z.jpg,427,640,3,1,0.714425206,158,114,37.00234192,17.8125,0,114,264,422
bicycle,yolov8l,16679943419_b0fd9b6858_z.jpg,427,640,3,1,0.713038206,89,77,20.84309133,12.03125,424,501,77,166
bicycle,yolov8l,16679943419_b0fd9b6858_z.jpg,427,640,3,1,0.590272844,103,37,24.12177986,5.78125,0,37,321,424
bicycle,yolov8l,16679943419_b0fd9b6858_z.jpg,427,640,3,1,0.538653493,39,39,9.133489461,6.09375,300,339,197,236
bicycle,yolov8l,16679943419_b0fd9b6858_z.jpg,427,640,3,1,0.528219342,108,88,25.29274005,13.75,412,500,189,297
bicycle,yolov8l,16679943419_b0fd9b6858_z.jpg,427,640,3,1,0.492511123,115,107,26.93208431,16.71875,110,217,61,176
bicycle,yolov8l,16679943419_b0fd9b6858_z.jpg,427,640,3,1,0.457191736,40,36,9.367681499,5.625,216,252,129,169
bicycle,yolov8l,16679943419_b0fd9b6858_z.jpg,427,640,3,1,0.396220326,62,59,14.51990632,9.21875,392,451,190,252
bicycle,yolov8l,16679943419_b0fd9b6858_z.jpg,427,640,3,1,0.394283503,56,30,13.1147541,4.6875,610,640,369,425
bicycle,yolov8l,16679943419_b0fd9b6858_z.jpg,427,640,3,1,0.346157104,73,76,17.09601874,11.875,394,470,196,269
bicycle,yolov8l,16679943419_b0fd9b6858_z.jpg,427,640,3,1,0.327193439,65,69,15.22248244,10.78125,361,430,182,247
bicycle,yolov8l,16679943419_b0fd9b6858_z.jpg,427,640,3,1,0.303196192,95,103,22.24824356,16.09375,107,210,211,306
bicycle,yolov8l,16679943419_b0fd9b6858_z.jpg,427,640,3,1,0.303138673,80,94,18.735363,14.6875,404,498,189,269
bicycle,yolov8l,16679943419_b0fd9b6858_z.jpg,427,640,3,1,0.281657815,87,82,20.37470726,12.8125,153,235,188,275
bicycle,yolov8l,16679943419_b0fd9b6858_z.jpg,427,640,3,1,0.268317193,117,172,27.40046838,26.875,45,217,61,178
bicycle,yolov8l,16679943419_b0fd9b6858_z.jpg,427,640,3,1,0.254394621,106,30,24.82435597,4.6875,610,640,318,424
bicycle,yolov8l,3452990622_cfb5fba34a_z.jpg,480,640,3,1,0.909540772,284,205,59.16666667,32.03125,170,375,161,445
bicycle,yolov8l,3452990622_cfb5fba34a_z.jpg,480,640,3,1,0.626461446,98,50,20.41666667,7.8125,130,180,118,216
bicycle,yolov8l,3452990622_cfb5fba34a_z.jpg,480,640,3,1,0.615746617,238,278,49.58333333,43.4375,297,575,242,480
bicycle,yolov8l,3452990622_cfb5fba34a_z.jpg,480,640,3,1,0.372546017,45,14,9.375,2.1875,370,384,99,144
bicycle,yolov8l,3452990622_cfb5fba34a_z.jpg,480,640,3,1,0.300608426,46,19,9.583333333,2.96875,367,386,98,144
bicycle,yolov8l,3452990622_cfb5fba34a_z.jpg,480,640,3,1,0.266591966,37,12,7.708333333,1.875,371,383,107,144
bicycle,yolov8l,3452990622_cfb5fba34a_z.jpg,480,640,3,1,0.345942587,51,47,10.625,7.34375,192,239,120,171
bicycle,yolov8l,3452990622_cfb5fba34a_z.jpg,480,640,3,1,0.313333571,98,94,20.41666667,14.6875,130,224,118,216
bicycle,yolov8l,5877731495_29cc1a6c57_z.jpg,426,640,3,1,0.954339743,236,221,55.39906103,34.53125,224,445,152,388
bicycle,yolov8l,2882148223_72d4df2a8e_z.jpg,480,640,3,1,0.893288016,450,599,93.75,93.59375,22,621,28,478
bicycle,yolov8l,6102395478_8c004e1142_z.jpg,480,640,3,1,0.956775844,453,639,94.375,99.84375,0,639,26,479
bicycle,yolov8l,7548613890_a6272237ac_z.jpg,640,480,3,1,0.965099275,434,397,67.8125,82.70833333,67,464,65,499
bicycle,yolov8l,7548613890_a6272237ac_z.jpg,640,480,3,1,0.877441525,245,237,38.28125,49.375,243,480,73,318
bicycle,yolov8l,7548613890_a6272237ac_z.jpg,640,480,3,1,0.733106792,369,131,57.65625,27.29166667,0,131,270,639
bicycle,yolov8l,2784964324_0b0373fd24_z.jpg,480,640,3,1,0.948450029,232,196,48.33333333,30.625,122,318,178,410
bicycle,yolov8l,8773393046_236298c465_z.jpg,427,640,3,1,0.744260669,213,458,49.88290398,71.5625,65,523,2,215
bicycle,yolov8l,14289042367_a041af95f4_z.jpg,427,640,3,1,0.967568636,172,426,40.28103044,66.5625,78,504,192,364
bicycle,yolov8l,1229448893_42c357ea12_z.jpg,400,640,3,1,0.852665007,393,355,98.25,55.46875,273,628,1,394
bicycle,yolov8l,5506132265_d6d43548eb_z.jpg,427,640,3,1,0.841287076,393,597,92.03747073,93.28125,0,597,28,421
bicycle,yolov8l,6117174227_6e5da0556b_z.jpg,640,427,3,1,0.573278189,137,289,21.40625,67.68149883,129,418,390,527
bicycle,yolov8l,6117174227_6e5da0556b_z.jpg,640,427,3,1,0.256023794,257,291,40.15625,68.1498829,127,418,270,527
bicycle,yolov8l,541124874_7247349bb7_z.jpg,640,427,3,1,0.95078212,342,317,53.4375,74.23887588,48,365,284,626
bicycle,yolov8l,541124874_7247349bb7_z.jpg,640,427,3,1,0.897615492,127,94,19.84375,22.01405152,307,401,238,365
bicycle,yolov8l,541124874_7247349bb7_z.jpg,640,427,3,1,0.677772701,106,88,16.5625,20.6088993,223,311,243,349
bicycle,yolov8l,541124874_7247349bb7_z.jpg,640,427,3,1,0.670964241,135,65,21.09375,15.22248244,6,71,260,395
bicycle,yolov8l,541124874_7247349bb7_z.jpg,640,427,3,1,0.511614263,31,26,4.84375,6.088992974,363,389,209,240
bicycle,yolov8l,13368340424_5c1f322f72_z.jpg,480,640,3,1,0.969048619,450,570,93.75,89.0625,24,594,30,480
bicycle,yolov8l,4763265058_6c6dbb9abe_z.jpg,427,640,3,1,0.6963076,417,639,97.65807963,99.84375,1,640,3,420
bicycle,yolov8l,4763265058_6c6dbb9abe_z.jpg,427,640,3,1,0.598209858,289,441,67.68149883,68.90625,199,640,6,295
bicycle,yolov8l,4763265058_6c6dbb9abe_z.jpg,427,640,3,1,0.584479213,108,233,25.29274005,36.40625,407,640,55,163
bicycle,yolov8l,4763265058_6c6dbb9abe_z.jpg,427,640,3,1,0.420962542,124,308,29.03981265,48.125,332,640,1,125
bicycle,yolov8l,4763265058_6c6dbb9abe_z.jpg,427,640,3,1,0.313200116,155,235,36.29976581,36.71875,405,640,61,216
bicycle,yolov8l,4763265058_6c6dbb9abe_z.jpg,427,640,3,1,0.274674147,165,349,38.64168618,54.53125,290,639,11,176
bicycle,yolov8l,4763265058_6c6dbb9abe_z.jpg,427,640,3,1,0.272281468,194,372,45.43325527,58.125,267,639,23,217
bicycle,yolov8l,1908136167_cae3414e7e_z.jpg,428,640,3,1,0.876720965,287,124,67.05607477,19.375,197,321,20,307
bicycle,yolov8l,1908136167_cae3414e7e_z.jpg,428,640,3,1,0.85455358,274,121,64.01869159,18.90625,487,608,66,340
bicycle,yolov8l,1908136167_cae3414e7e_z.jpg,428,640,3,1,0.74754709,276,117,64.48598131,18.28125,395,512,42,318
bicycle,yolov8l,1908136167_cae3414e7e_z.jpg,428,640,3,1,0.722591162,286,89,66.82242991,13.90625,551,640,72,358
bicycle,yolov8l,1908136167_cae3414e7e_z.jpg,428,640,3,1,0.686590612,211,289,49.29906542,45.15625,103,392,188,399
bicycle,yolov8l,1908136167_cae3414e7e_z.jpg,428,640,3,1,0.521614671,281,165,65.65420561,25.78125,37,202,31,312
bicycle,yolov8l,1908136167_cae3414e7e_z.jpg,428,640,3,1,0.477820069,272,115,63.55140187,17.96875,308,423,57,329
bicycle,yolov8l,1908136167_cae3414e7e_z.jpg,428,640,3,1,0.455683142,212,51,49.53271028,7.96875,317,368,108,320
bicycle,yolov8l,1908136167_cae3414e7e_z.jpg,428,640,3,1,0.404741555,265,59,61.91588785,9.21875,387,446,59,324
bicycle,yolov8l,1908136167_cae3414e7e_z.jpg,428,640,3,1,0.404444158,277,55,64.71962617,8.59375,0,55,42,319
bicycle,yolov8l,1908136167_cae3414e7e_z.jpg,428,640,3,1,0.281789809,273,75,63.78504673,11.71875,436,511,43,316
bicycle,yolov8l,1908136167_cae3414e7e_z.jpg,428,640,3,1,0.262691081,292,298,68.22429907,46.5625,92,390,107,399
bicycle,yolov8l,2136213674_4e484d88e3_z.jpg,640,480,3,1,0.959262967,379,367,59.21875,76.45833333,106,473,191,570
bicycle,yolov8l,2136213674_4e484d88e3_z.jpg,640,480,3,1,0.321094811,102,136,15.9375,28.33333333,0,136,49,151
bicycle,yolov8m,5021039430_0cda148fd5_z.jpg,640,427,3,1,0.95287168,353,282,55.15625,66.04215457,63,345,258,611
bicycle,yolov8m,5021039430_0cda148fd5_z.jpg,640,427,3,1,0.886510491,133,66,20.78125,15.45667447,360,426,281,414
bicycle,yolov8m,5021039430_0cda148fd5_z.jpg,640,427,3,1,0.859912157,174,112,27.1875,26.2295082,0,112,328,502
bicycle,yolov8m,5021039430_0cda148fd5_z.jpg,640,427,3,1,0.438388705,56,78,8.75,18.26697892,27,105,297,353
bicycle,yolov8m,9157606630_2ef852a3ee_z.jpg,640,427,3,1,0.935779154,156,225,24.375,52.69320843,123,348,218,374
bicycle,yolov8m,18608021442_84f7dcfa5c_z.jpg,480,640,3,1,0.716826975,155,345,32.29166667,53.90625,98,443,226,381
bicycle,yolov8m,159051371_77f7d02bb6_z.jpg,480,640,3,1,0.92139101,472,477,98.33333333,74.53125,95,572,1,473
bicycle,yolov8m,3666190087_ca2fb0d709_z.jpg,480,640,3,1,0.917437255,351,514,73.125,80.3125,86,600,36,387
bicycle,yolov8m,2788056049_b71f8998c7_z.jpg,640,480,3,1,0.793229043,115,111,17.96875,23.125,368,479,469,584
bicycle,yolov8m,2788056049_b71f8998c7_z.jpg,640,480,3,1,0.740261972,95,77,14.84375,16.04166667,256,333,378,473
bicycle,yolov8m,14652913468_5d3b2a39f1_z.jpg,480,640,3,1,0.967027426,395,530,82.29166667,82.8125,4,534,84,479
bicycle,yolov8m,3446761063_9cdc26f36c_z.jpg,426,640,3,1,0.920815289,202,345,47.41784038,53.90625,59,404,168,370
bicycle,yolov8m,9688658716_4b3e9c618c_z.jpg,427,640,3,1,0.893650413,215,379,50.35128806,59.21875,261,640,209,424
bicycle,yolov8m,9688658716_4b3e9c618c_z.jpg,427,640,3,1,0.578393996,162,166,37.93911007,25.9375,260,426,262,424
bicycle,yolov8m,7417962302_a50fc8eb6b_z.jpg,425,640,3,1,0.949142933,91,169,21.41176471,26.40625,52,221,192,283
bicycle,yolov8m,7417962302_a50fc8eb6b_z.jpg,425,640,3,1,0.938309371,161,322,37.88235294,50.3125,201,523,262,423
bicycle,yolov8m,7417962302_a50fc8eb6b_z.jpg,425,640,3,1,0.666539967,87,36,20.47058824,5.625,0,36,192,279
bicycle,yolov8m,7417962302_a50fc8eb6b_z.jpg,425,640,3,1,0.56429255,58,36,13.64705882,5.625,0,36,221,279
bicycle,yolov8m,3685504815_c15a389bd3_z.jpg,480,640,3,1,0.937097192,228,344,47.5,53.75,147,491,175,403
bicycle,yolov8m,8289650934_506c73242a_z.jpg,612,612,3,1,0.945113063,423,585,69.11764706,95.58823529,15,600,116,539
bicycle,yolov8m,4625462281_7df55484bb_z.jpg,426,640,3,1,0.904668152,281,130,65.96244131,20.3125,407,537,64,345
bicycle,yolov8m,4625462281_7df55484bb_z.jpg,426,640,3,1,0.897621334,403,277,94.60093897,43.28125,5,282,18,421
bicycle,yolov8m,4625462281_7df55484bb_z.jpg,426,640,3,1,0.66312623,120,94,28.16901408,14.6875,546,640,303,423
bicycle,yolov8m,4625462281_7df55484bb_z.jpg,426,640,3,1,0.478112698,311,266,73.00469484,41.5625,172,438,53,364
bicycle,yolov8m,4625462281_7df55484bb_z.jpg,426,640,3,1,0.452345788,332,125,77.9342723,19.53125,0,125,32,364
bicycle,yolov8m,4625462281_7df55484bb_z.jpg,426,640,3,1,0.41466409,366,392,85.91549296,61.25,46,438,15,381
bicycle,yolov8m,6771874127_f8f380b3cb_z.jpg,425,640,3,1,0.850448489,415,631,97.64705882,98.59375,8,639,4,419
bicycle,yolov8m,4349979920_189df35e15_z.jpg,480,640,3,1,0.917392313,284,443,59.16666667,69.21875,149,592,71,355
bicycle,yolov8m,5816846412_7b6fa97da0_z.jpg,427,640,3,1,0.705980957,403,553,94.3793911,86.40625,54,607,10,413
bicycle,yolov8m,5816846412_7b6fa97da0_z.jpg,427,640,3,1,0.391999245,285,169,66.74473068,26.40625,47,216,10,295
bicycle,yolov8m,82903264_5dd277c32d_z.jpg,480,640,3,1,0.903025448,154,159,32.08333333,24.84375,15,174,265,419
bicycle,yolov8m,82903264_5dd277c32d_z.jpg,480,640,3,1,0.866992116,199,221,41.45833333,34.53125,189,410,247,446
bicycle,yolov8m,82903264_5dd277c32d_z.jpg,480,640,3,1,0.379617661,118,95,24.58333333,14.84375,353,448,247,365
bicycle,yolov8m,82903264_5dd277c32d_z.jpg,480,640,3,1,0.351891041,123,137,25.625,21.40625,311,448,243,366
bicycle,yolov8m,82903264_5dd277c32d_z.jpg,480,640,3,1,0.29836604,107,91,22.29166667,14.21875,190,281,337,444
bicycle,yolov8m,2258982401_762044a41d_z.jpg,480,640,3,1,0.941620708,214,350,44.58333333,54.6875,284,634,178,392
bicycle,yolov8m,6141562070_11880edf2e_z.jpg,425,639,3,0,0,0,0,0,0,0,0,0,0
bicycle,yolov8m,5402229494_570e48f7f9_z.jpg,427,640,3,1,0.954262972,290,319,67.91569087,49.84375,0,319,1,291
bicycle,yolov8m,5402229494_570e48f7f9_z.jpg,427,640,3,1,0.605149269,288,493,67.44730679,77.03125,81,574,123,411
bicycle,yolov8m,3715997008_28a251eba7_z.jpg,425,640,3,0,0,0,0,0,0,0,0,0,0
bicycle,yolov8m,5877730305_f5e3d13667_z.jpg,427,640,3,1,0.925864279,264,284,61.82669789,44.375,304,588,122,386
bicycle,yolov8m,15235483580_08696e0988_z.jpg,640,427,3,1,0.879282355,340,169,53.125,39.57845433,127,296,235,575
bicycle,yolov8m,224422461_dddd4c8e99_z.jpg,480,640,3,1,0.675779402,230,340,47.91666667,53.125,53,393,225,455
bicycle,yolov8m,224422461_dddd4c8e99_z.jpg,480,640,3,1,0.318437904,279,552,58.125,86.25,40,592,174,453
bicycle,yolov8m,224422461_dddd4c8e99_z.jpg,480,640,3,1,0.296823055,278,327,57.91666667,51.09375,268,595,176,454
bicycle,yolov8m,8291522231_19e1414c1b_z.jpg,612,612,3,1,0.555939794,533,480,87.09150327,78.43137255,26,506,11,544
bicycle,yolov8m,16675918410_cc9588a553_z.jpg,359,640,3,0,0,0,0,0,0,0,0,0,0
bicycle,yolov8m,2746929519_3599d54cfb_z.jpg,480,640,3,1,0.850014269,164,72,34.16666667,11.25,0,72,9,173
bicycle,yolov8m,2746929519_3599d54cfb_z.jpg,480,640,3,1,0.700119019,445,564,92.70833333,88.125,4,568,19,464
bicycle,yolov8m,5708252159_5b4ac86a01_z.jpg,480,640,3,1,0.898433566,374,526,77.91666667,82.1875,94,620,106,480
bicycle,yolov8m,5708252159_5b4ac86a01_z.jpg,480,640,3,1,0.893854976,117,176,24.375,27.5,251,427,0,117
bicycle,yolov8m,3353007655_56889b94a7_z.jpg,480,640,3,1,0.942483366,152,81,31.66666667,12.65625,281,362,222,374
bicycle,yolov8m,14265143426_0770389597_z.jpg,407,640,3,0,0,0,0,0,0,0,0,0,0
bicycle,yolov8m,8651904899_c2632fe751_z.jpg,427,640,3,0,0,0,0,0,0,0,0,0,0
bicycle,yolov8m,1553312291_c0cae48a37_z.jpg,640,287,3,1,0.970895171,158,271,24.6875,94.42508711,8,279,45,203
bicycle,yolov8m,1553312291_c0cae48a37_z.jpg,640,287,3,1,0.912316978,203,119,31.71875,41.46341463,147,266,433,636
bicycle,yolov8m,1553312291_c0cae48a37_z.jpg,640,287,3,1,0.850395679,208,142,32.5,49.47735192,0,142,214,422
bicycle,yolov8m,1553312291_c0cae48a37_z.jpg,640,287,3,1,0.386823118,144,138,22.5,48.08362369,0,138,471,615
bicycle,yolov8m,9755183855_953c4f062c_z.jpg,425,640,3,1,0.455388308,122,180,28.70588235,28.125,264,444,299,421
bicycle,yolov8m,5971377496_abc7d794c7_z.jpg,480,640,3,1,0.963132977,265,270,55.20833333,42.1875,111,381,215,480
bicycle,yolov8m,6459633873_5effb4b6e5_z.jpg,426,640,3,1,0.969239056,311,456,73.00469484,71.25,110,566,93,404
bicycle,yolov8m,11484364375_4180af41fc_z.jpg,427,640,3,1,0.96335721,356,567,83.37236534,88.59375,37,604,32,388
bicycle,yolov8m,8106854318_06c1cc0fc3_z.jpg,480,640,3,1,0.961256862,356,628,74.16666667,98.125,8,636,61,417
bicycle,yolov8m,296513213_9681371ed9_z.jpg,426,640,3,1,0.284163266,413,551,96.94835681,86.09375,3,554,2,415
bicycle,yolov8m,3747524_f07f508ba9_z.jpg,640,504,3,1,0.906693816,280,345,43.75,68.45238095,73,418,222,502
bicycle,yolov8m,18068160735_6c2f214265_z.jpg,480,640,3,0,0,0,0,0,0,0,0,0,0
bicycle,yolov8m,9141188655_328b195d8d_z.jpg,427,640,3,1,0.937138915,247,137,57.84543326,21.40625,293,430,173,420
bicycle,yolov8m,21376683791_d98acff014_z.jpg,640,640,3,1,0.93493259,457,559,71.40625,87.34375,19,578,126,583
bicycle,yolov8m,3604271495_1cacccec06_z.jpg,427,640,3,0,0,0,0,0,0,0,0,0,0
bicycle,yolov8m,51712355_49c2e95899_z.jpg,427,640,3,1,0.718850195,143,330,33.48946136,51.5625,227,557,167,310
bicycle,yolov8m,7675033952_b3caa0dd37_z.jpg,639,480,3,1,0.951290846,273,280,42.72300469,58.33333333,0,280,312,585
bicycle,yolov8m,14757587416_892a95bf77_z.jpg,360,640,3,1,0.723348022,182,68,50.55555556,10.625,273,341,175,357
bicycle,yolov8m,14757587416_892a95bf77_z.jpg,360,640,3,1,0.669224918,126,95,35,14.84375,412,507,231,357
bicycle,yolov8m,2179537346_d695661bbc_z.jpg,640,425,3,1,0.710252881,175,87,27.34375,20.47058824,190,277,417,592
bicycle,yolov8m,2179537346_d695661bbc_z.jpg,640,425,3,1,0.441054195,252,119,39.375,28,162,281,340,592
bicycle,yolov8m,14628257582_1ff5e98e4c_z.jpg,400,640,3,0,0,0,0,0,0,0,0,0,0
bicycle,yolov8m,19474810921_d2f23de0fc_z.jpg,480,640,3,0,0,0,0,0,0,0,0,0,0
bicycle,yolov8m,234597792_a9f1e7e7a9_z.jpg,425,639,3,1,0.627361715,74,233,17.41176471,36.46322379,279,512,348,422
bicycle,yolov8m,15333662010_2f428f7e2f_z.jpg,480,640,3,1,0.940690577,185,183,38.54166667,28.59375,400,583,211,396
bicycle,yolov8m,15333662010_2f428f7e2f_z.jpg,480,640,3,1,0.919759333,181,274,37.70833333,42.8125,0,274,207,388
bicycle,yolov8m,15333662010_2f428f7e2f_z.jpg,480,640,3,1,0.482147187,82,87,17.08333333,13.59375,187,274,199,281
bicycle,yolov8m,414586991_9630094229_z.jpg,516,640,3,1,0.921222746,485,456,93.99224806,71.25,31,487,15,500
bicycle,yolov8m,414586991_9630094229_z.jpg,516,640,3,1,0.826836467,381,468,73.8372093,73.125,153,621,38,419
bicycle,yolov8m,414586991_9630094229_z.jpg,516,640,3,1,0.422631115,229,106,44.37984496,16.5625,156,262,42,271
bicycle,yolov8m,414586991_9630094229_z.jpg,516,640,3,1,0.325334787,185,165,35.85271318,25.78125,37,202,13,198
bicycle,yolov8m,2883059364_a6ccfaf69a_z.jpg,480,640,3,1,0.912044525,302,539,62.91666667,84.21875,60,599,74,376
bicycle,yolov8m,4484760806_dc814d2ce2_z.jpg,640,425,3,1,0.944160461,260,336,40.625,79.05882353,42,378,272,532
bicycle,yolov8m,6816985831_893d039421_z.jpg,425,640,3,1,0.641212702,351,599,82.58823529,93.59375,24,623,58,409
bicycle,yolov8m,14811525368_d8b774e40a_z.jpg,425,640,3,1,0.766745389,180,90,42.35294118,14.0625,315,405,207,387
bicycle,yolov8m,14811525368_d8b774e40a_z.jpg,425,640,3,1,0.589865625,96,31,22.58823529,4.84375,284,315,183,279
bicycle,yolov8m,5599702283_8562638984_z.jpg,427,640,3,1,0.911012948,394,526,92.27166276,82.1875,50,576,1,395
bicycle,yolov8m,6076857457_7a06e6ab35_z.jpg,478,640,3,1,0.879359066,140,119,29.28870293,18.59375,514,633,104,244
bicycle,yolov8m,1511658057_17b7bac11a_z.jpg,398,640,3,1,0.658448875,105,145,26.38190955,22.65625,180,325,148,253
bicycle,yolov8m,1511658057_17b7bac11a_z.jpg,398,640,3,1,0.561697543,134,190,33.66834171,29.6875,2,192,220,354
bicycle,yolov8m,1511658057_17b7bac11a_z.jpg,398,640,3,1,0.475242943,138,202,34.67336683,31.5625,431,633,238,376
bicycle,yolov8m,4065552857_98aa8a39d4_z.jpg,427,640,3,1,0.852665365,70,120,16.39344262,18.75,519,639,222,292
bicycle,yolov8m,4065552857_98aa8a39d4_z.jpg,427,640,3,1,0.783952951,208,129,48.71194379,20.15625,40,169,186,394
bicycle,yolov8m,4065552857_98aa8a39d4_z.jpg,427,640,3,1,0.512192726,107,64,25.05854801,10,220,284,206,313
bicycle,yolov8m,4065552857_98aa8a39d4_z.jpg,427,640,3,1,0.32372874,118,181,27.63466042,28.28125,281,462,306,424
bicycle,yolov8m,4065552857_98aa8a39d4_z.jpg,427,640,3,1,0.312338054,107,132,25.05854801,20.625,223,355,206,313
bicycle,yolov8m,4065552857_98aa8a39d4_z.jpg,427,640,3,1,0.268307924,74,41,17.33021077,6.40625,312,353,232,306
bicycle,yolov8m,9444094315_ba610ed94a_z.jpg,640,441,3,1,0.892284811,313,178,48.90625,40.36281179,180,358,224,537
bicycle,yolov8m,16679943419_b0fd9b6858_z.jpg,427,640,3,1,0.836861432,162,131,37.93911007,20.46875,509,640,237,399
bicycle,yolov8m,16679943419_b0fd9b6858_z.jpg,427,640,3,1,0.834673464,117,117,27.40046838,18.28125,100,217,61,178
bicycle,yolov8m,16679943419_b0fd9b6858_z.jpg,427,640,3,1,0.79358393,158,115,37.00234192,17.96875,525,640,30,188
bicycle,yolov8m,16679943419_b0fd9b6858_z.jpg,427,640,3,1,0.791829765,143,117,33.48946136,18.28125,2,119,7,150
bicycle,yolov8m,16679943419_b0fd9b6858_z.jpg,427,640,3,1,0.761826575,168,174,39.3442623,27.1875,465,639,180,348
bicycle,yolov8m,16679943419_b0fd9b6858_z.jpg,427,640,3,1,0.758426785,157,56,36.76814988,8.75,0,56,26,183
bicycle,yolov8m,16679943419_b0fd9b6858_z.jpg,427,640,3,1,0.640581012,54,31,12.64637002,4.84375,609,640,371,425
bicycle,yolov8m,16679943419_b0fd9b6858_z.jpg,427,640,3,1,0.59735626,101,37,23.65339578,5.78125,0,37,323,424
bicycle,yolov8m,16679943419_b0fd9b6858_z.jpg,427,640,3,1,0.573606551,161,149,37.70491803,23.28125,490,639,1,162
bicycle,yolov8m,16679943419_b0fd9b6858_z.jpg,427,640,3,1,0.546980739,128,124,29.9765808,19.375,438,562,188,316
bicycle,yolov8m,16679943419_b0fd9b6858_z.jpg,427,640,3,1,0.539009035,134,111,31.38173302,17.34375,1,112,290,424
bicycle,yolov8m,16679943419_b0fd9b6858_z.jpg,427,640,3,1,0.506609976,100,136,23.41920375,21.25,423,559,67,167
bicycle,yolov8m,16679943419_b0fd9b6858_z.jpg,427,640,3,1,0.476256907,42,38,9.836065574,5.9375,214,252,128,170
bicycle,yolov8m,16679943419_b0fd9b6858_z.jpg,427,640,3,1,0.442795426,79,76,18.50117096,11.875,361,437,167,246
bicycle,yolov8m,16679943419_b0fd9b6858_z.jpg,427,640,3,1,0.431706578,96,92,22.4824356,14.375,413,505,201,297
bicycle,yolov8m,16679943419_b0fd9b6858_z.jpg,427,640,3,1,0.29211235,179,153,41.92037471,23.90625,4,157,189,368
bicycle,yolov8m,16679943419_b0fd9b6858_z.jpg,427,640,3,1,0.259201139,100,83,23.41920375,12.96875,0,83,187,287
bicycle,yolov8m,16679943419_b0fd9b6858_z.jpg,427,640,3,1,0.25736472,57,44,13.34894614,6.875,382,426,123,180
bicycle,yolov8m,16679943419_b0fd9b6858_z.jpg,427,640,3,1,0.252995789,54,40,12.64637002,6.25,0,40,195,249
bicycle,yolov8m,3452990622_cfb5fba34a_z.jpg,480,640,3,1,0.911836624,281,201,58.54166667,31.40625,173,374,164,445
bicycle,yolov8m,3452990622_cfb5fba34a_z.jpg,480,640,3,1,0.747707486,97,99,20.20833333,15.46875,129,228,119,216
bicycle,yolov8m,3452990622_cfb5fba34a_z.jpg,480,640,3,1,0.745060921,229,271,47.70833333,42.34375,312,583,251,480
bicycle,yolov8m,3452990622_cfb5fba34a_z.jpg,480,640,3,1,0.548008978,44,21,9.166666667,3.28125,366,387,99,143
bicycle,yolov8m,3452990622_cfb5fba34a_z.jpg,480,640,3,1,0.274227798,38,16,7.916666667,2.5,368,384,106,144
bicycle,yolov8m,5877731495_29cc1a6c57_z.jpg,426,640,3,1,0.944235384,228,220,53.52112676,34.375,225,445,159,387
bicycle,yolov8m,2882148223_72d4df2a8e_z.jpg,480,640,3,1,0.414605826,438,516,91.25,80.625,105,621,37,475
bicycle,yolov8m,6102395478_8c004e1142_z.jpg,480,640,3,1,0.856182396,453,636,94.375,99.375,2,638,25,478
bicycle,yolov8m,7548613890_a6272237ac_z.jpg,640,480,3,1,0.95052731,436,437,68.125,91.04166667,26,463,64,500
bicycle,yolov8m,7548613890_a6272237ac_z.jpg,640,480,3,1,0.888731539,282,228,44.0625,47.5,252,480,36,318
bicycle,yolov8m,7548613890_a6272237ac_z.jpg,640,480,3,1,0.681286693,369,130,57.65625,27.08333333,0,130,270,639
bicycle,yolov8m,2784964324_0b0373fd24_z.jpg,480,640,3,1,0.940461397,228,196,47.5,30.625,123,319,181,409
bicycle,yolov8m,8773393046_236298c465_z.jpg,427,640,3,0,0,0,0,0,0,0,0,0,0
bicycle,yolov8m,14289042367_a041af95f4_z.jpg,427,640,3,1,0.938796461,173,426,40.51522248,66.5625,78,504,191,364
bicycle,yolov8m,1229448893_42c357ea12_z.jpg,400,640,3,1,0.907285631,394,357,98.5,55.78125,272,629,0,394
bicycle,yolov8m,5506132265_d6d43548eb_z.jpg,427,640,3,1,0.733244717,395,597,92.5058548,93.28125,0,597,27,422
bicycle,yolov8m,5506132265_d6d43548eb_z.jpg,427,640,3,1,0.503525615,393,359,92.03747073,56.09375,237,596,28,421
bicycle,yolov8m,5506132265_d6d43548eb_z.jpg,427,640,3,1,0.331132561,365,404,85.48009368,63.125,1,405,56,421
bicycle,yolov8m,6117174227_6e5da0556b_z.jpg,640,427,3,0,0,0,0,0,0,0,0,0,0
bicycle,yolov8m,541124874_7247349bb7_z.jpg,640,427,3,1,0.951648355,343,317,53.59375,74.23887588,48,365,282,625
bicycle,yolov8m,541124874_7247349bb7_z.jpg,640,427,3,1,0.868593991,126,94,19.6875,22.01405152,306,400,239,365
bicycle,yolov8m,541124874_7247349bb7_z.jpg,640,427,3,1,0.767319441,132,67,20.625,15.69086651,12,79,262,394
bicycle,yolov8m,541124874_7247349bb7_z.jpg,640,427,3,1,0.57225281,99,75,15.46875,17.56440281,222,297,242,341
bicycle,yolov8m,541124874_7247349bb7_z.jpg,640,427,3,1,0.275711387,31,27,4.84375,6.323185012,362,389,210,241
bicycle,yolov8m,13368340424_5c1f322f72_z.jpg,480,640,3,1,0.949462354,455,568,94.79166667,88.75,22,590,25,480
bicycle,yolov8m,4763265058_6c6dbb9abe_z.jpg,427,640,3,1,0.913327873,416,638,97.42388759,99.6875,1,639,4,420
bicycle,yolov8m,4763265058_6c6dbb9abe_z.jpg,427,640,3,1,0.319767267,101,201,23.65339578,31.40625,439,640,25,126
bicycle,yolov8m,4763265058_6c6dbb9abe_z.jpg,427,640,3,1,0.29895097,47,184,11.00702576,28.75,455,639,1,48
bicycle,yolov8m,4763265058_6c6dbb9abe_z.jpg,427,640,3,1,0.298811316,141,234,33.02107728,36.5625,405,639,60,201
bicycle,yolov8m,4763265058_6c6dbb9abe_z.jpg,427,640,3,1,0.289983213,185,372,43.32552693,58.125,267,639,47,232
bicycle,yolov8m,4763265058_6c6dbb9abe_z.jpg,427,640,3,1,0.279365331,133,354,31.14754098,55.3125,285,639,33,166
bicycle,yolov8m,4763265058_6c6dbb9abe_z.jpg,427,640,3,1,0.26121527,107,246,25.05854801,38.4375,394,640,54,161
bicycle,yolov8m,1908136167_cae3414e7e_z.jpg,428,640,3,1,0.890016854,276,141,64.48598131,22.03125,468,609,65,341
bicycle,yolov8m,1908136167_cae3414e7e_z.jpg,428,640,3,1,0.832932293,369,355,86.21495327,55.46875,36,391,30,399
bicycle,yolov8m,1908136167_cae3414e7e_z.jpg,428,640,3,1,0.800185263,260,113,60.74766355,17.65625,197,310,14,274
bicycle,yolov8m,1908136167_cae3414e7e_z.jpg,428,640,3,1,0.688168347,274,126,64.01869159,19.6875,308,434,54,328
bicycle,yolov8m,1908136167_cae3414e7e_z.jpg,428,640,3,1,0.662776887,227,119,53.03738318,18.59375,391,510,39,266
bicycle,yolov8m,1908136167_cae3414e7e_z.jpg,428,640,3,1,0.648204029,276,89,64.48598131,13.90625,0,89,43,319
bicycle,yolov8m,1908136167_cae3414e7e_z.jpg,428,640,3,1,0.565569162,220,93,51.40186916,14.53125,547,640,68,288
bicycle,yolov8m,1908136167_cae3414e7e_z.jpg,428,640,3,1,0.267410696,274,157,64.01869159,24.53125,36,193,32,306
bicycle,yolov8m,2136213674_4e484d88e3_z.jpg,640,480,3,1,0.887564957,384,367,60,76.45833333,106,473,188,572
bicycle,yolov8n,5021039430_0cda148fd5_z.jpg,640,427,3,1,0.90542084,359,283,56.09375,66.2763466,62,345,253,612
bicycle,yolov8n,5021039430_0cda148fd5_z.jpg,640,427,3,1,0.896289349,143,67,22.34375,15.69086651,360,427,272,415
bicycle,yolov8n,5021039430_0cda148fd5_z.jpg,640,427,3,1,0.401976436,159,111,24.84375,25.99531616,0,111,343,502
bicycle,yolov8n,5021039430_0cda148fd5_z.jpg,640,427,3,1,0.358777046,56,100,8.75,23.41920375,7,107,302,358
bicycle,yolov8n,5021039430_0cda148fd5_z.jpg,640,427,3,1,0.261923224,297,111,46.40625,25.99531616,0,111,205,502
bicycle,yolov8n,5021039430_0cda148fd5_z.jpg,640,427,3,1,0.25937289,67,86,10.46875,20.14051522,22,108,288,355
bicycle,yolov8n,9157606630_2ef852a3ee_z.jpg,640,427,3,1,0.761916578,159,231,24.84375,54.09836066,118,349,216,375
bicycle,yolov8n,18608021442_84f7dcfa5c_z.jpg,480,640,3,1,0.316160291,99,136,20.625,21.25,307,443,226,325
bicycle,yolov8n,159051371_77f7d02bb6_z.jpg,480,640,3,1,0.634576261,475,447,98.95833333,69.84375,138,585,3,478
bicycle,yolov8n,3666190087_ca2fb0d709_z.jpg,480,640,3,1,0.754262447,352,506,73.33333333,79.0625,94,600,35,387
bicycle,yolov8n,2788056049_b71f8998c7_z.jpg,640,480,3,0,0,0,0,0,0,0,0,0,0
bicycle,yolov8n,14652913468_5d3b2a39f1_z.jpg,480,640,3,1,0.312118679,371,445,77.29166667,69.53125,90,535,109,480
bicycle,yolov8n,3446761063_9cdc26f36c_z.jpg,426,640,3,1,0.912187934,221,344,51.87793427,53.75,58,402,150,371
bicycle,yolov8n,9688658716_4b3e9c618c_z.jpg,427,640,3,1,0.461792767,177,386,41.45199063,60.3125,253,639,245,422
bicycle,yolov8n,7417962302_a50fc8eb6b_z.jpg,425,640,3,1,0.935729682,95,169,22.35294118,26.40625,52,221,189,284
bicycle,yolov8n,7417962302_a50fc8eb6b_z.jpg,425,640,3,1,0.856999457,170,322,40,50.3125,202,524,253,423
bicycle,yolov8n,7417962302_a50fc8eb6b_z.jpg,425,640,3,1,0.616407931,87,37,20.47058824,5.78125,0,37,192,279
bicycle,yolov8n,3685504815_c15a389bd3_z.jpg,480,640,3,1,0.90745163,225,346,46.875,54.0625,146,492,176,401
bicycle,yolov8n,8289650934_506c73242a_z.jpg,612,612,3,1,0.70872581,421,562,68.79084967,91.83006536,33,595,126,547
bicycle,yolov8n,4625462281_7df55484bb_z.jpg,426,640,3,1,0.775956869,405,462,95.07042254,72.1875,2,464,15,420
bicycle,yolov8n,4625462281_7df55484bb_z.jpg,426,640,3,1,0.726184368,288,131,67.6056338,20.46875,409,540,56,344
bicycle,yolov8n,4625462281_7df55484bb_z.jpg,426,640,3,1,0.367706507,129,96,30.28169014,15,544,640,293,422
bicycle,yolov8n,6771874127_f8f380b3cb_z.jpg,425,640,3,0,0,0,0,0,0,0,0,0,0
bicycle,yolov8n,4349979920_189df35e15_z.jpg,480,640,3,1,0.641492844,282,503,58.75,78.59375,82,585,70,352
bicycle,yolov8n,5816846412_7b6fa97da0_z.jpg,427,640,3,0,0,0,0,0,0,0,0,0,0
bicycle,yolov8n,82903264_5dd277c32d_z.jpg,480,640,3,1,0.71171701,155,164,32.29166667,25.625,13,177,264,419
bicycle,yolov8n,82903264_5dd277c32d_z.jpg,480,640,3,1,0.687810421,199,221,41.45833333,34.53125,191,412,248,447
bicycle,yolov8n,82903264_5dd277c32d_z.jpg,480,640,3,1,0.460202605,155,115,32.29166667,17.96875,296,411,246,401
bicycle,yolov8n,82903264_5dd277c32d_z.jpg,480,640,3,1,0.405720145,122,105,25.41666667,16.40625,342,447,244,366
bicycle,yolov8n,2258982401_762044a41d_z.jpg,480,640,3,1,0.939847529,229,351,47.70833333,54.84375,285,636,166,395
bicycle,yolov8n,6141562070_11880edf2e_z.jpg,425,639,3,0,0,0,0,0,0,0,0,0,0
bicycle,yolov8n,5402229494_570e48f7f9_z.jpg,427,640,3,1,0.473834991,404,588,94.61358314,91.875,5,593,6,410
bicycle,yolov8n,5402229494_570e48f7f9_z.jpg,427,640,3,1,0.402502269,288,288,67.44730679,45,0,288,2,290
bicycle,yolov8n,3715997008_28a251eba7_z.jpg,425,640,3,0,0,0,0,0,0,0,0,0,0
bicycle,yolov8n,5877730305_f5e3d13667_z.jpg,427,640,3,1,0.925838113,270,286,63.23185012,44.6875,303,589,119,389
bicycle,yolov8n,15235483580_08696e0988_z.jpg,640,427,3,0,0,0,0,0,0,0,0,0,0
bicycle,yolov8n,224422461_dddd4c8e99_z.jpg,480,640,3,1,0.68404752,278,421,57.91666667,65.78125,184,605,176,454
bicycle,yolov8n,224422461_dddd4c8e99_z.jpg,480,640,3,1,0.531164944,238,335,49.58333333,52.34375,54,389,216,454
bicycle,yolov8n,8291522231_19e1414c1b_z.jpg,612,612,3,1,0.553784311,458,449,74.83660131,73.36601307,54,503,65,523
bicycle,yolov8n,16675918410_cc9588a553_z.jpg,359,640,3,0,0,0,0,0,0,0,0,0,0
bicycle,yolov8n,2746929519_3599d54cfb_z.jpg,480,640,3,1,0.850058556,171,72,35.625,11.25,0,72,4,175
bicycle,yolov8n,2746929519_3599d54cfb_z.jpg,480,640,3,1,0.792721033,248,282,51.66666667,44.0625,285,567,218,466
bicycle,yolov8n,2746929519_3599d54cfb_z.jpg,480,640,3,1,0.553186178,286,313,59.58333333,48.90625,70,383,8,294
bicycle,yolov8n,2746929519_3599d54cfb_z.jpg,480,640,3,1,0.466237873,468,595,97.5,92.96875,7,602,2,470
bicycle,yolov8n,5708252159_5b4ac86a01_z.jpg,480,640,3,1,0.886573076,118,175,24.58333333,27.34375,252,427,0,118
bicycle,yolov8n,5708252159_5b4ac86a01_z.jpg,480,640,3,1,0.832308054,383,536,79.79166667,83.75,85,621,97,480
bicycle,yolov8n,3353007655_56889b94a7_z.jpg,480,640,3,1,0.815346241,155,83,32.29166667,12.96875,281,364,219,374
bicycle,yolov8n,14265143426_0770389597_z.jpg,407,640,3,0,0,0,0,0,0,0,0,0,0
bicycle,yolov8n,8651904899_c2632fe751_z.jpg,427,640,3,1,0.354767799,266,450,62.29508197,70.3125,139,589,139,405
bicycle,yolov8n,1553312291_c0cae48a37_z.jpg,640,287,3,1,0.946796775,157,270,24.53125,94.07665505,9,279,46,203
bicycle,yolov8n,1553312291_c0cae48a37_z.jpg,640,287,3,1,0.46148482,208,120,32.5,41.81184669,146,266,430,638
bicycle,yolov8n,1553312291_c0cae48a37_z.jpg,640,287,3,1,0.309532642,194,131,30.3125,45.6445993,12,143,226,420
bicycle,yolov8n,9755183855_953c4f062c_z.jpg,425,640,3,0,0,0,0,0,0,0,0,0,0
bicycle,yolov8n,5971377496_abc7d794c7_z.jpg,480,640,3,1,0.719080985,267,271,55.625,42.34375,111,382,212,479
bicycle,yolov8n,6459633873_5effb4b6e5_z.jpg,426,640,3,1,0.8936553,306,441,71.83098592,68.90625,111,552,96,402
bicycle,yolov8n,11484364375_4180af41fc_z.jpg,427,640,3,1,0.444599628,350,566,81.96721311,88.4375,49,615,41,391
bicycle,yolov8n,8106854318_06c1cc0fc3_z.jpg,480,640,3,1,0.915904582,365,620,76.04166667,96.875,16,636,59,424
bicycle,yolov8n,296513213_9681371ed9_z.jpg,426,640,3,0,0,0,0,0,0,0,0,0,0
bicycle,yolov8n,3747524_f07f508ba9_z.jpg,640,504,3,1,0.601443589,306,343,47.8125,68.05555556,75,418,196,502
bicycle,yolov8n,18068160735_6c2f214265_z.jpg,480,640,3,0,0,0,0,0,0,0,0,0,0
bicycle,yolov8n,9141188655_328b195d8d_z.jpg,427,640,3,1,0.814711213,247,139,57.84543326,21.71875,292,431,172,419
bicycle,yolov8n,21376683791_d98acff014_z.jpg,640,640,3,1,0.79922235,454,547,70.9375,85.46875,30,577,125,579
bicycle,yolov8n,3604271495_1cacccec06_z.jpg,427,640,3,0,0,0,0,0,0,0,0,0,0
bicycle,yolov8n,51712355_49c2e95899_z.jpg,427,640,3,1,0.534683108,89,184,20.84309133,28.75,374,558,194,283
bicycle,yolov8n,7675033952_b3caa0dd37_z.jpg,639,480,3,1,0.929442704,277,278,43.34898279,57.91666667,0,278,309,586
bicycle,yolov8n,14757587416_892a95bf77_z.jpg,360,640,3,1,0.285954982,170,92,47.22222222,14.375,256,348,188,358
bicycle,yolov8n,2179537346_d695661bbc_z.jpg,640,425,3,1,0.383177221,259,137,40.46875,32.23529412,161,298,334,593
bicycle,yolov8n,14628257582_1ff5e98e4c_z.jpg,400,640,3,0,0,0,0,0,0,0,0,0,0
bicycle,yolov8n,19474810921_d2f23de0fc_z.jpg,480,640,3,0,0,0,0,0,0,0,0,0,0
bicycle,yolov8n,234597792_a9f1e7e7a9_z.jpg,425,639,3,0,0,0,0,0,0,0,0,0,0
bicycle,yolov8n,15333662010_2f428f7e2f_z.jpg,480,640,3,1,0.931615114,188,183,39.16666667,28.59375,401,584,208,396
bicycle,yolov8n,15333662010_2f428f7e2f_z.jpg,480,640,3,1,0.906762421,182,275,37.91666667,42.96875,0,275,211,393
bicycle,yolov8n,414586991_9630094229_z.jpg,516,640,3,1,0.774413109,442,484,85.65891473,75.625,111,595,43,485
bicycle,yolov8n,414586991_9630094229_z.jpg,516,640,3,1,0.506564081,189,164,36.62790698,25.625,40,204,11,200
bicycle,yolov8n,2883059364_a6ccfaf69a_z.jpg,480,640,3,1,0.868265033,349,538,72.70833333,84.0625,61,599,67,416
bicycle,yolov8n,4484760806_dc814d2ce2_z.jpg,640,425,3,1,0.832248032,266,338,41.5625,79.52941176,40,378,267,533
bicycle,yolov8n,6816985831_893d039421_z.jpg,425,640,3,0,0,0,0,0,0,0,0,0,0
bicycle,yolov8n,14811525368_d8b774e40a_z.jpg,425,640,3,1,0.53231889,184,118,43.29411765,18.4375,301,419,194,378
bicycle,yolov8n,14811525368_d8b774e40a_z.jpg,425,640,3,1,0.314027995,100,50,23.52941176,7.8125,284,334,182,282
bicycle,yolov8n,5599702283_8562638984_z.jpg,427,640,3,1,0.889071107,387,540,90.6323185,84.375,36,576,2,389
bicycle,yolov8n,6076857457_7a06e6ab35_z.jpg,478,640,3,1,0.770365834,142,112,29.70711297,17.5,514,626,104,246
bicycle,yolov8n,6076857457_7a06e6ab35_z.jpg,478,640,3,1,0.709993422,397,375,83.05439331,58.59375,114,489,47,444
bicycle,yolov8n,6076857457_7a06e6ab35_z.jpg,478,640,3,1,0.284834146,134,76,28.0334728,11.875,434,510,177,311
bicycle,yolov8n,1511658057_17b7bac11a_z.jpg,398,640,3,1,0.659272373,101,144,25.37688442,22.5,181,325,150,251
bicycle,yolov8n,1511658057_17b7bac11a_z.jpg,398,640,3,1,0.513988912,186,190,46.73366834,29.6875,1,191,163,349
bicycle,yolov8n,4065552857_98aa8a39d4_z.jpg,427,640,3,1,0.6437217,205,105,48.00936768,16.40625,39,144,188,393
bicycle,yolov8n,4065552857_98aa8a39d4_z.jpg,427,640,3,1,0.38146925,143,167,33.48946136,26.09375,118,285,186,329
bicycle,yolov8n,4065552857_98aa8a39d4_z.jpg,427,640,3,1,0.377433002,72,121,16.8618267,18.90625,518,639,222,294
bicycle,yolov8n,9444094315_ba610ed94a_z.jpg,640,441,3,1,0.591745973,333,182,52.03125,41.26984127,178,360,203,536
bicycle,yolov8n,16679943419_b0fd9b6858_z.jpg,427,640,3,1,0.862107098,191,130,44.73067916,20.3125,510,640,208,399
bicycle,yolov8n,16679943419_b0fd9b6858_z.jpg,427,640,3,1,0.619952142,184,118,43.09133489,18.4375,522,640,3,187
bicycle,yolov8n,16679943419_b0fd9b6858_z.jpg,427,640,3,1,0.524395049,145,105,33.95784543,16.40625,0,105,279,424
bicycle,yolov8n,16679943419_b0fd9b6858_z.jpg,427,640,3,1,0.421527594,141,144,33.02107728,22.5,465,609,208,349
bicycle,yolov8n,16679943419_b0fd9b6858_z.jpg,427,640,3,1,0.413337469,120,84,28.1030445,13.125,438,522,199,319
bicycle,yolov8n,16679943419_b0fd9b6858_z.jpg,427,640,3,1,0.40209958,134,116,31.38173302,18.125,101,217,45,179
bicycle,yolov8n,16679943419_b0fd9b6858_z.jpg,427,640,3,1,0.372912139,168,175,39.3442623,27.34375,464,639,183,351
bicycle,yolov8n,16679943419_b0fd9b6858_z.jpg,427,640,3,1,0.365189105,146,115,34.19203747,17.96875,4,119,8,154
bicycle,yolov8n,16679943419_b0fd9b6858_z.jpg,427,640,3,1,0.351001829,74,58,17.33021077,9.0625,152,210,231,305
bicycle,yolov8n,16679943419_b0fd9b6858_z.jpg,427,640,3,1,0.338423461,178,56,41.68618267,8.75,0,56,5,183
bicycle,yolov8n,16679943419_b0fd9b6858_z.jpg,427,640,3,1,0.33371228,74,66,17.33021077,10.3125,361,427,175,249
bicycle,yolov8n,16679943419_b0fd9b6858_z.jpg,427,640,3,1,0.315845221,104,133,24.3559719,20.78125,0,133,271,375
bicycle,yolov8n,16679943419_b0fd9b6858_z.jpg,427,640,3,1,0.289682597,109,141,25.52693208,22.03125,419,560,60,169
bicycle,yolov8n,16679943419_b0fd9b6858_z.jpg,427,640,3,1,0.273005486,86,77,20.14051522,12.03125,163,240,185,271
bicycle,yolov8n,16679943419_b0fd9b6858_z.jpg,427,640,3,1,0.256345421,103,102,24.12177986,15.9375,49,151,266,369
bicycle,yolov8n,16679943419_b0fd9b6858_z.jpg,427,640,3,1,0.250305772,97,134,22.71662763,20.9375,394,528,168,265
bicycle,yolov8n,3452990622_cfb5fba34a_z.jpg,480,640,3,1,0.870674491,275,195,57.29166667,30.46875,179,374,171,446
bicycle,yolov8n,3452990622_cfb5fba34a_z.jpg,480,640,3,1,0.519194424,189,289,39.375,45.15625,288,577,291,480
bicycle,yolov8n,3452990622_cfb5fba34a_z.jpg,480,640,3,1,0.383585274,39,20,8.125,3.125,366,386,105,144
bicycle,yolov8n,3452990622_cfb5fba34a_z.jpg,480,640,3,1,0.315819889,121,118,25.20833333,18.4375,131,249,96,217
bicycle,yolov8n,3452990622_cfb5fba34a_z.jpg,480,640,3,1,0.313374072,252,372,52.5,58.125,206,578,226,478
bicycle,yolov8n,5877731495_29cc1a6c57_z.jpg,426,640,3,1,0.922257602,256,219,60.09389671,34.21875,226,445,133,389
bicycle,yolov8n,2882148223_72d4df2a8e_z.jpg,480,640,3,1,0.309333056,394,585,82.08333333,91.40625,46,631,85,479
bicycle,yolov8n,6102395478_8c004e1142_z.jpg,480,640,3,0,0,0,0,0,0,0,0,0,0
bicycle,yolov8n,7548613890_a6272237ac_z.jpg,640,480,3,1,0.875024796,439,421,68.59375,87.70833333,45,466,60,499
bicycle,yolov8n,7548613890_a6272237ac_z.jpg,640,480,3,1,0.528649986,267,255,41.71875,53.125,224,479,51,318
bicycle,yolov8n,7548613890_a6272237ac_z.jpg,640,480,3,1,0.265696824,371,127,57.96875,26.45833333,0,127,267,638
bicycle,yolov8n,2784964324_0b0373fd24_z.jpg,480,640,3,1,0.949943185,228,196,47.5,30.625,122,318,179,407
bicycle,yolov8n,8773393046_236298c465_z.jpg,427,640,3,0,0,0,0,0,0,0,0,0,0
bicycle,yolov8n,14289042367_a041af95f4_z.jpg,427,640,3,1,0.890006363,174,423,40.74941452,66.09375,80,503,190,364
bicycle,yolov8n,1229448893_42c357ea12_z.jpg,400,640,3,1,0.867557168,397,356,99.25,55.625,272,628,0,397
bicycle,yolov8n,5506132265_d6d43548eb_z.jpg,427,640,3,1,0.691739023,399,591,93.44262295,92.34375,10,601,25,424
bicycle,yolov8n,5506132265_d6d43548eb_z.jpg,427,640,3,1,0.44759953,366,456,85.71428571,71.25,1,457,55,421
bicycle,yolov8n,5506132265_d6d43548eb_z.jpg,427,640,3,1,0.405980736,402,371,94.14519906,57.96875,216,587,22,424
bicycle,yolov8n,6117174227_6e5da0556b_z.jpg,640,427,3,1,0.323122263,230,292,35.9375,68.38407494,127,419,297,527
bicycle,yolov8n,541124874_7247349bb7_z.jpg,640,427,3,1,0.82804507,300,315,46.875,73.7704918,50,365,324,624
bicycle,yolov8n,541124874_7247349bb7_z.jpg,640,427,3,1,0.600834966,119,93,18.59375,21.77985948,308,401,245,364
bicycle,yolov8n,541124874_7247349bb7_z.jpg,640,427,3,1,0.533074141,104,90,16.25,21.07728337,231,321,245,349
bicycle,yolov8n,541124874_7247349bb7_z.jpg,640,427,3,1,0.376975507,91,74,14.21875,17.33021077,249,323,258,349
bicycle,yolov8n,541124874_7247349bb7_z.jpg,640,427,3,1,0.33036235,124,53,19.375,12.41217799,14,67,271,395
bicycle,yolov8n,13368340424_5c1f322f72_z.jpg,480,640,3,1,0.887624145,464,580,96.66666667,90.625,16,596,16,480
bicycle,yolov8n,4763265058_6c6dbb9abe_z.jpg,427,640,3,1,0.534986198,410,631,96.01873536,98.59375,3,634,15,425
bicycle,yolov8n,1908136167_cae3414e7e_z.jpg,428,640,3,1,0.500912786,273,133,63.78504673,20.78125,476,609,73,346
bicycle,yolov8n,1908136167_cae3414e7e_z.jpg,428,640,3,1,0.49447161,339,327,79.20560748,51.09375,65,392,61,400
bicycle,yolov8n,1908136167_cae3414e7e_z.jpg,428,640,3,1,0.485981494,295,92,68.92523364,14.375,547,639,61,356
bicycle,yolov8n,1908136167_cae3414e7e_z.jpg,428,640,3,1,0.394296288,345,169,80.60747664,26.40625,2,171,30,375
bicycle,yolov8n,1908136167_cae3414e7e_z.jpg,428,640,3,1,0.388787985,334,95,78.03738318,14.84375,0,95,37,371
bicycle,yolov8n,1908136167_cae3414e7e_z.jpg,428,640,3,1,0.292851388,293,126,68.45794393,19.6875,335,461,51,344
bicycle,yolov8n,1908136167_cae3414e7e_z.jpg,428,640,3,1,0.285435319,255,109,59.57943925,17.03125,234,343,27,282
bicycle,yolov8n,2136213674_4e484d88e3_z.jpg,640,480,3,0,0,0,0,0,0,0,0,0,0
bicycle,yolov8s,5021039430_0cda148fd5_z.jpg,640,427,3,1,0.955937624,354,281,55.3125,65.80796253,63,344,258,612
bicycle,yolov8s,5021039430_0cda148fd5_z.jpg,640,427,3,1,0.795786083,129,65,20.15625,15.22248244,360,425,285,414
bicycle,yolov8s,5021039430_0cda148fd5_z.jpg,640,427,3,1,0.681840241,291,111,45.46875,25.99531616,0,111,210,501
bicycle,yolov8s,5021039430_0cda148fd5_z.jpg,640,427,3,1,0.445713699,56,84,8.75,19.67213115,22,106,298,354
bicycle,yolov8s,5021039430_0cda148fd5_z.jpg,640,427,3,1,0.376006961,173,111,27.03125,25.99531616,0,111,328,501
bicycle,yolov8s,9157606630_2ef852a3ee_z.jpg,640,427,3,1,0.877234101,160,229,25,53.62997658,120,349,215,375
bicycle,yolov8s,18608021442_84f7dcfa5c_z.jpg,480,640,3,1,0.435809076,97,134,20.20833333,20.9375,309,443,226,323
bicycle,yolov8s,159051371_77f7d02bb6_z.jpg,480,640,3,1,0.828354478,471,441,98.125,68.90625,137,578,2,473
bicycle,yolov8s,159051371_77f7d02bb6_z.jpg,480,640,3,1,0.289258689,328,224,68.33333333,35,96,320,1,329
bicycle,yolov8s,3666190087_ca2fb0d709_z.jpg,480,640,3,1,0.659994245,351,513,73.125,80.15625,90,603,35,386
bicycle,yolov8s,2788056049_b71f8998c7_z.jpg,640,480,3,1,0.299120098,64,74,10,15.41666667,258,332,379,443
bicycle,yolov8s,14652913468_5d3b2a39f1_z.jpg,480,640,3,1,0.852741063,415,565,86.45833333,88.28125,1,566,65,480
bicycle,yolov8s,3446761063_9cdc26f36c_z.jpg,426,640,3,1,0.945984364,207,344,48.5915493,53.75,59,403,164,371
bicycle,yolov8s,9688658716_4b3e9c618c_z.jpg,427,640,3,1,0.700336754,165,164,38.64168618,25.625,261,425,259,424
bicycle,yolov8s,9688658716_4b3e9c618c_z.jpg,427,640,3,1,0.526427448,201,379,47.07259953,59.21875,261,640,222,423
bicycle,yolov8s,7417962302_a50fc8eb6b_z.jpg,425,640,3,1,0.947567105,158,322,37.17647059,50.3125,201,523,264,422
bicycle,yolov8s,7417962302_a50fc8eb6b_z.jpg,425,640,3,1,0.921652973,92,169,21.64705882,26.40625,52,221,191,283
bicycle,yolov8s,7417962302_a50fc8eb6b_z.jpg,425,640,3,1,0.574245155,57,37,13.41176471,5.78125,0,37,222,279
bicycle,yolov8s,7417962302_a50fc8eb6b_z.jpg,425,640,3,1,0.513667107,89,36,20.94117647,5.625,0,36,190,279
bicycle,yolov8s,3685504815_c15a389bd3_z.jpg,480,640,3,1,0.931610942,232,344,48.33333333,53.75,147,491,168,400
bicycle,yolov8s,8289650934_506c73242a_z.jpg,612,612,3,1,0.903378248,431,576,70.4248366,94.11764706,21,597,109,540
bicycle,yolov8s,4625462281_7df55484bb_z.jpg,426,640,3,1,0.835005403,288,133,67.6056338,20.78125,407,540,56,344
bicycle,yolov8s,4625462281_7df55484bb_z.jpg,426,640,3,1,0.820892751,406,469,95.30516432,73.28125,6,475,12,418
bicycle,yolov8s,4625462281_7df55484bb_z.jpg,426,640,3,1,0.709086001,120,95,28.16901408,14.84375,545,640,303,423
bicycle,yolov8s,6771874127_f8f380b3cb_z.jpg,425,640,3,1,0.827282548,413,621,97.17647059,97.03125,19,640,0,413
bicycle,yolov8s,6771874127_f8f380b3cb_z.jpg,425,640,3,1,0.354851782,317,540,74.58823529,84.375,2,542,94,411
bicycle,yolov8s,4349979920_189df35e15_z.jpg,480,640,3,1,0.806955636,286,442,59.58333333,69.0625,141,583,70,356
bicycle,yolov8s,4349979920_189df35e15_z.jpg,480,640,3,1,0.251015484,215,233,44.79166667,36.40625,73,306,71,286
bicycle,yolov8s,5816846412_7b6fa97da0_z.jpg,427,640,3,1,0.558456659,283,164,66.2763466,25.625,49,213,13,296
bicycle,yolov8s,82903264_5dd277c32d_z.jpg,480,640,3,1,0.769725502,196,222,40.83333333,34.6875,189,411,253,449
bicycle,yolov8s,82903264_5dd277c32d_z.jpg,480,640,3,1,0.566026986,122,128,25.41666667,20,319,447,243,365
bicycle,yolov8s,82903264_5dd277c32d_z.jpg,480,640,3,1,0.518002272,182,262,37.91666667,40.9375,18,280,265,447
bicycle,yolov8s,82903264_5dd277c32d_z.jpg,480,640,3,1,0.486930847,141,114,29.375,17.8125,297,411,259,400
bicycle,yolov8s,82903264_5dd277c32d_z.jpg,480,640,3,1,0.478362888,153,156,31.875,24.375,19,175,265,418
bicycle,yolov8s,82903264_5dd277c32d_z.jpg,480,640,3,1,0.288035214,94,86,19.58333333,13.4375,312,398,242,336
bicycle,yolov8s,2258982401_762044a41d_z.jpg,480,640,3,1,0.94522506,219,350,45.625,54.6875,284,634,174,393
bicycle,yolov8s,6141562070_11880edf2e_z.jpg,425,639,3,0,0,0,0,0,0,0,0,0,0
bicycle,yolov8s,5402229494_570e48f7f9_z.jpg,427,640,3,1,0.827306688,292,295,68.38407494,46.09375,0,295,1,293
bicycle,yolov8s,5402229494_570e48f7f9_z.jpg,427,640,3,1,0.389610261,319,501,74.70725995,78.28125,82,583,92,411
bicycle,yolov8s,3715997008_28a251eba7_z.jpg,425,640,3,0,0,0,0,0,0,0,0,0,0
bicycle,yolov8s,5877730305_f5e3d13667_z.jpg,427,640,3,1,0.934192419,255,286,59.71896956,44.6875,304,590,132,387
bicycle,yolov8s,15235483580_08696e0988_z.jpg,640,427,3,1,0.888290405,340,208,53.125,48.71194379,110,318,237,577
bicycle,yolov8s,224422461_dddd4c8e99_z.jpg,480,640,3,1,0.680199146,230,340,47.91666667,53.125,53,393,224,454
bicycle,yolov8s,8291522231_19e1414c1b_z.jpg,612,612,3,1,0.275701761,488,496,79.73856209,81.04575163,30,526,56,544
bicycle,yolov8s,16675918410_cc9588a553_z.jpg,359,640,3,0,0,0,0,0,0,0,0,0,0
bicycle,yolov8s,2746929519_3599d54cfb_z.jpg,480,640,3,1,0.856895626,164,72,34.16666667,11.25,0,72,9,173
bicycle,yolov8s,2746929519_3599d54cfb_z.jpg,480,640,3,1,0.419383436,459,554,95.625,86.5625,17,571,9,468
bicycle,yolov8s,2746929519_3599d54cfb_z.jpg,480,640,3,1,0.302448332,243,280,50.625,43.75,286,566,221,464
bicycle,yolov8s,5708252159_5b4ac86a01_z.jpg,480,640,3,1,0.918837905,117,177,24.375,27.65625,251,428,0,117
bicycle,yolov8s,5708252159_5b4ac86a01_z.jpg,480,640,3,1,0.916554451,377,536,78.54166667,83.75,91,627,103,480
bicycle,yolov8s,5708252159_5b4ac86a01_z.jpg,480,640,3,1,0.270125151,161,238,33.54166667,37.1875,54,292,106,267
bicycle,yolov8s,3353007655_56889b94a7_z.jpg,480,640,3,1,0.874269843,151,82,31.45833333,12.8125,281,363,223,374
bicycle,yolov8s,14265143426_0770389597_z.jpg,407,640,3,0,0,0,0,0,0,0,0,0,0
bicycle,yolov8s,8651904899_c2632fe751_z.jpg,427,640,3,0,0,0,0,0,0,0,0,0,0
bicycle,yolov8s,1553312291_c0cae48a37_z.jpg,640,287,3,1,0.961164117,157,270,24.53125,94.07665505,9,279,46,203
bicycle,yolov8s,1553312291_c0cae48a37_z.jpg,640,287,3,1,0.861643791,207,103,32.34375,35.88850174,163,266,430,637
bicycle,yolov8s,1553312291_c0cae48a37_z.jpg,640,287,3,1,0.374820799,207,142,32.34375,49.47735192,1,143,213,420
bicycle,yolov8s,9755183855_953c4f062c_z.jpg,425,640,3,0,0,0,0,0,0,0,0,0,0
bicycle,yolov8s,5971377496_abc7d794c7_z.jpg,480,640,3,1,0.943445623,263,271,54.79166667,42.34375,110,381,217,480
bicycle,yolov8s,6459633873_5effb4b6e5_z.jpg,426,640,3,1,0.931074739,308,455,72.30046948,71.09375,109,564,94,402
bicycle,yolov8s,11484364375_4180af41fc_z.jpg,427,640,3,1,0.698248148,359,579,84.07494145,90.46875,41,620,31,390
bicycle,yolov8s,8106854318_06c1cc0fc3_z.jpg,480,640,3,1,0.93861568,365,625,76.04166667,97.65625,5,630,57,422
bicycle,yolov8s,296513213_9681371ed9_z.jpg,426,640,3,0,0,0,0,0,0,0,0,0,0
bicycle,yolov8s,3747524_f07f508ba9_z.jpg,640,504,3,1,0.856646955,276,344,43.125,68.25396825,75,419,225,501
bicycle,yolov8s,18068160735_6c2f214265_z.jpg,480,640,3,0,0,0,0,0,0,0,0,0,0
bicycle,yolov8s,9141188655_328b195d8d_z.jpg,427,640,3,1,0.860240281,243,133,56.90866511,20.78125,297,430,176,419
bicycle,yolov8s,21376683791_d98acff014_z.jpg,640,640,3,1,0.956738234,450,564,70.3125,88.125,13,577,124,574
bicycle,yolov8s,3604271495_1cacccec06_z.jpg,427,640,3,0,0,0,0,0,0,0,0,0,0
bicycle,yolov8s,51712355_49c2e95899_z.jpg,427,640,3,1,0.385392398,194,334,45.43325527,52.1875,224,558,116,310
bicycle,yolov8s,7675033952_b3caa0dd37_z.jpg,639,480,3,1,0.939443767,277,280,43.34898279,58.33333333,0,280,309,586
bicycle,yolov8s,14757587416_892a95bf77_z.jpg,360,640,3,1,0.646549463,182,84,50.55555556,13.125,270,354,173,355
bicycle,yolov8s,14757587416_892a95bf77_z.jpg,360,640,3,1,0.574032426,127,98,35.27777778,15.3125,411,509,231,358
bicycle,yolov8s,2179537346_d695661bbc_z.jpg,640,425,3,1,0.713326871,175,90,27.34375,21.17647059,189,279,417,592
bicycle,yolov8s,14628257582_1ff5e98e4c_z.jpg,400,640,3,1,0.663701892,350,628,87.5,98.125,7,635,43,393
bicycle,yolov8s,19474810921_d2f23de0fc_z.jpg,480,640,3,0,0,0,0,0,0,0,0,0,0
bicycle,yolov8s,234597792_a9f1e7e7a9_z.jpg,425,639,3,1,0.291813284,74,232,17.41176471,36.30672926,280,512,348,422
bicycle,yolov8s,15333662010_2f428f7e2f_z.jpg,480,640,3,1,0.950008035,176,274,36.66666667,42.8125,0,274,210,386
bicycle,yolov8s,15333662010_2f428f7e2f_z.jpg,480,640,3,1,0.89623642,185,183,38.54166667,28.59375,400,583,210,395
bicycle,yolov8s,15333662010_2f428f7e2f_z.jpg,480,640,3,1,0.424687177,81,86,16.875,13.4375,188,274,198,279
bicycle,yolov8s,414586991_9630094229_z.jpg,516,640,3,1,0.739871979,460,454,89.14728682,70.9375,133,587,38,498
bicycle,yolov8s,414586991_9630094229_z.jpg,516,640,3,1,0.5757671,485,439,93.99224806,68.59375,29,468,11,496
bicycle,yolov8s,2883059364_a6ccfaf69a_z.jpg,480,640,3,1,0.801259398,345,546,71.875,85.3125,55,601,60,405
bicycle,yolov8s,4484760806_dc814d2ce2_z.jpg,640,425,3,1,0.897015095,267,338,41.71875,79.52941176,40,378,266,533
bicycle,yolov8s,6816985831_893d039421_z.jpg,425,640,3,1,0.461037576,368,529,86.58823529,82.65625,58,587,54,422
bicycle,yolov8s,6816985831_893d039421_z.jpg,425,640,3,1,0.355624557,237,389,55.76470588,60.78125,23,412,160,397
bicycle,yolov8s,14811525368_d8b774e40a_z.jpg,425,640,3,1,0.769985259,177,91,41.64705882,14.21875,325,416,206,383
bicycle,yolov8s,14811525368_d8b774e40a_z.jpg,425,640,3,1,0.430684566,97,31,22.82352941,4.84375,283,314,184,281
bicycle,yolov8s,14811525368_d8b774e40a_z.jpg,425,640,3,1,0.309763044,96,49,22.58823529,7.65625,283,332,185,281
bicycle,yolov8s,5599702283_8562638984_z.jpg,427,640,3,1,0.870640576,370,531,86.65105386,82.96875,46,577,1,371
bicycle,yolov8s,6076857457_7a06e6ab35_z.jpg,478,640,3,1,0.842452109,141,112,29.49790795,17.5,515,627,104,245
bicycle,yolov8s,6076857457_7a06e6ab35_z.jpg,478,640,3,1,0.675463736,398,388,83.26359833,60.625,119,507,42,440
bicycle,yolov8s,6076857457_7a06e6ab35_z.jpg,478,640,3,1,0.265989006,116,67,24.26778243,10.46875,572,639,119,235
bicycle,yolov8s,1511658057_17b7bac11a_z.jpg,398,640,3,1,0.755234599,118,145,29.64824121,22.65625,181,326,135,253
bicycle,yolov8s,1511658057_17b7bac11a_z.jpg,398,640,3,1,0.508243859,137,201,34.42211055,31.40625,432,633,238,375
bicycle,yolov8s,4065552857_98aa8a39d4_z.jpg,427,640,3,1,0.853369534,201,130,47.07259953,20.3125,39,169,194,395
bicycle,yolov8s,4065552857_98aa8a39d4_z.jpg,427,640,3,1,0.79230094,73,122,17.09601874,19.0625,518,640,219,292
bicycle,yolov8s,4065552857_98aa8a39d4_z.jpg,427,640,3,1,0.555907309,108,66,25.29274005,10.3125,220,286,206,314
bicycle,yolov8s,4065552857_98aa8a39d4_z.jpg,427,640,3,1,0.530419707,114,197,26.69789227,30.78125,268,465,310,424
bicycle,yolov8s,4065552857_98aa8a39d4_z.jpg,427,640,3,1,0.508024156,114,118,26.69789227,18.4375,348,466,310,424
bicycle,yolov8s,4065552857_98aa8a39d4_z.jpg,427,640,3,1,0.38331008,109,109,25.52693208,17.03125,221,330,205,314
bicycle,yolov8s,4065552857_98aa8a39d4_z.jpg,427,640,3,1,0.25657329,206,89,48.24355972,13.90625,41,130,188,394
bicycle,yolov8s,9444094315_ba610ed94a_z.jpg,640,441,3,1,0.733996987,309,181,48.28125,41.0430839,179,360,225,534
bicycle,yolov8s,16679943419_b0fd9b6858_z.jpg,427,640,3,1,0.843604922,167,130,39.11007026,20.3125,510,640,231,398
bicycle,yolov8s,16679943419_b0fd9b6858_z.jpg,427,640,3,1,0.733192444,151,156,35.36299766,24.375,466,622,199,350
bicycle,yolov8s,16679943419_b0fd9b6858_z.jpg,427,640,3,1,0.703634679,169,116,39.57845433,18.125,524,640,16,185
bicycle,yolov8s,16679943419_b0fd9b6858_z.jpg,427,640,3,1,0.645100355,137,114,32.08430913,17.8125,0,114,288,425
bicycle,yolov8s,16679943419_b0fd9b6858_z.jpg,427,640,3,1,0.61211735,158,146,37.00234192,22.8125,492,638,0,158
bicycle,yolov8s,16679943419_b0fd9b6858_z.jpg,427,640,3,1,0.599928856,148,120,34.66042155,18.75,0,120,1,149
bicycle,yolov8s,16679943419_b0fd9b6858_z.jpg,427,640,3,1,0.589523673,55,31,12.88056206,4.84375,609,640,370,425
bicycle,yolov8s,16679943419_b0fd9b6858_z.jpg,427,640,3,1,0.546711445,115,111,26.93208431,17.34375,106,217,60,175
bicycle,yolov8s,16679943419_b0fd9b6858_z.jpg,427,640,3,1,0.482997566,121,153,28.33723653,23.90625,1,154,250,371
bicycle,yolov8s,16679943419_b0fd9b6858_z.jpg,427,640,3,1,0.479407877,120,125,28.1030445,19.53125,436,561,193,313
bicycle,yolov8s,16679943419_b0fd9b6858_z.jpg,427,640,3,1,0.448922485,163,214,38.17330211,33.4375,424,638,1,164
bicycle,yolov8s,16679943419_b0fd9b6858_z.jpg,427,640,3,1,0.387178361,97,89,22.71662763,13.90625,412,501,200,297
bicycle,yolov8s,16679943419_b0fd9b6858_z.jpg,427,640,3,1,0.383294702,124,127,29.03981265,19.84375,60,187,203,327
bicycle,yolov8s,16679943419_b0fd9b6858_z.jpg,427,640,3,1,0.355779767,90,79,21.07728337,12.34375,424,503,75,165
bicycle,yolov8s,16679943419_b0fd9b6858_z.jpg,427,640,3,1,0.319788843,162,57,37.93911007,8.90625,0,57,20,182
bicycle,yolov8s,16679943419_b0fd9b6858_z.jpg,427,640,3,1,0.285208195,127,162,29.74238876,25.3125,31,193,193,320
bicycle,yolov8s,16679943419_b0fd9b6858_z.jpg,427,640,3,1,0.285094529,95,88,22.24824356,13.75,121,209,211,306
bicycle,yolov8s,16679943419_b0fd9b6858_z.jpg,427,640,3,1,0.277064472,107,114,25.05854801,17.8125,411,525,195,302
bicycle,yolov8s,16679943419_b0fd9b6858_z.jpg,427,640,3,1,0.269314885,101,128,23.65339578,20,26,154,271,372
bicycle,yolov8s,16679943419_b0fd9b6858_z.jpg,427,640,3,1,0.265219629,83,71,19.43793911,11.09375,413,484,214,297
bicycle,yolov8s,16679943419_b0fd9b6858_z.jpg,427,640,3,1,0.263324648,103,96,24.12177986,15,438,534,213,316
bicycle,yolov8s,16679943419_b0fd9b6858_z.jpg,427,640,3,1,0.26107654,61,63,14.28571429,9.84375,195,258,187,248
bicycle,yolov8s,3452990622_cfb5fba34a_z.jpg,480,640,3,1,0.901955664,291,199,60.625,31.09375,174,373,154,445
bicycle,yolov8s,3452990622_cfb5fba34a_z.jpg,480,640,3,1,0.659521401,202,244,42.08333333,38.125,334,578,278,480
bicycle,yolov8s,3452990622_cfb5fba34a_z.jpg,480,640,3,1,0.614123344,97,100,20.20833333,15.625,130,230,118,215
bicycle,yolov8s,3452990622_cfb5fba34a_z.jpg,480,640,3,1,0.556902289,40,17,8.333333333,2.65625,369,386,103,143
bicycle,yolov8s,3452990622_cfb5fba34a_z.jpg,480,640,3,1,0.26361376,98,53,20.41666667,8.28125,130,183,118,216
bicycle,yolov8s,5877731495_29cc1a6c57_z.jpg,426,640,3,1,0.926211298,232,220,54.4600939,34.375,225,445,156,388
bicycle,yolov8s,2882148223_72d4df2a8e_z.jpg,480,640,3,0,0,0,0,0,0,0,0,0,0
bicycle,yolov8s,6102395478_8c004e1142_z.jpg,480,640,3,1,0.60934633,453,637,94.375,99.53125,1,638,25,478
bicycle,yolov8s,7548613890_a6272237ac_z.jpg,640,480,3,1,0.907259047,438,399,68.4375,83.125,65,464,61,499
bicycle,yolov8s,7548613890_a6272237ac_z.jpg,640,480,3,1,0.858481109,247,227,38.59375,47.29166667,253,480,71,318
bicycle,yolov8s,7548613890_a6272237ac_z.jpg,640,480,3,1,0.358028889,362,127,56.5625,26.45833333,0,127,274,636
bicycle,yolov8s,2784964324_0b0373fd24_z.jpg,480,640,3,1,0.955756962,230,198,47.91666667,30.9375,121,319,178,408
bicycle,yolov8s,8773393046_236298c465_z.jpg,427,640,3,0,0,0,0,0,0,0,0,0,0
bicycle,yolov8s,14289042367_a041af95f4_z.jpg,427,640,3,1,0.880285144,174,426,40.74941452,66.5625,77,503,188,362
bicycle,yolov8s,1229448893_42c357ea12_z.jpg,400,640,3,1,0.870713055,390,356,97.5,55.625,272,628,0,390
bicycle,yolov8s,5506132265_d6d43548eb_z.jpg,427,640,3,1,0.524678051,400,596,93.67681499,93.125,5,601,24,424
bicycle,yolov8s,5506132265_d6d43548eb_z.jpg,427,640,3,1,0.431489766,403,375,94.3793911,58.59375,227,602,21,424
bicycle,yolov8s,6117174227_6e5da0556b_z.jpg,640,427,3,0,0,0,0,0,0,0,0,0,0
bicycle,yolov8s,541124874_7247349bb7_z.jpg,640,427,3,1,0.803786457,124,94,19.375,22.01405152,307,401,240,364
bicycle,yolov8s,541124874_7247349bb7_z.jpg,640,427,3,1,0.768676817,340,317,53.125,74.23887588,48,365,284,624
bicycle,yolov8s,541124874_7247349bb7_z.jpg,640,427,3,1,0.697748899,106,89,16.5625,20.84309133,222,311,244,350
bicycle,yolov8s,541124874_7247349bb7_z.jpg,640,427,3,1,0.480145574,134,46,20.9375,10.77283372,18,64,263,397
bicycle,yolov8s,541124874_7247349bb7_z.jpg,640,427,3,1,0.312317848,138,78,21.5625,18.26697892,7,85,259,397
bicycle,yolov8s,13368340424_5c1f322f72_z.jpg,480,640,3,1,0.894821882,466,560,97.08333333,87.5,15,575,11,477
bicycle,yolov8s,4763265058_6c6dbb9abe_z.jpg,427,640,3,1,0.485243261,414,637,96.95550351,99.53125,2,639,8,422
bicycle,yolov8s,4763265058_6c6dbb9abe_z.jpg,427,640,3,1,0.405635715,101,205,23.65339578,32.03125,435,640,21,122
bicycle,yolov8s,4763265058_6c6dbb9abe_z.jpg,427,640,3,1,0.353112012,126,222,29.50819672,34.6875,418,640,79,205
bicycle,yolov8s,1908136167_cae3414e7e_z.jpg,428,640,3,1,0.827222347,258,107,60.28037383,16.71875,209,316,17,275
bicycle,yolov8s,1908136167_cae3414e7e_z.jpg,428,640,3,1,0.769947767,276,136,64.48598131,21.25,474,610,67,343
bicycle,yolov8s,1908136167_cae3414e7e_z.jpg,428,640,3,1,0.659596801,279,89,65.18691589,13.90625,551,640,76,355
bicycle,yolov8s,1908136167_cae3414e7e_z.jpg,428,640,3,1,0.591034889,342,350,79.90654206,54.6875,45,395,58,400
bicycle,yolov8s,1908136167_cae3414e7e_z.jpg,428,640,3,1,0.547723889,297,128,69.39252336,20,287,415,26,323
bicycle,yolov8s,1908136167_cae3414e7e_z.jpg,428,640,3,1,0.40420559,288,101,67.28971963,15.78125,0,101,38,326
bicycle,yolov8s,1908136167_cae3414e7e_z.jpg,428,640,3,1,0.389008015,194,64,45.3271028,10,446,510,73,267
bicycle,yolov8s,1908136167_cae3414e7e_z.jpg,428,640,3,1,0.313010365,236,119,55.14018692,18.59375,391,510,43,279
bicycle,yolov8s,1908136167_cae3414e7e_z.jpg,428,640,3,1,0.278392047,285,123,66.58878505,19.21875,310,433,47,332
bicycle,yolov8s,2136213674_4e484d88e3_z.jpg,640,480,3,1,0.812349558,381,361,59.53125,75.20833333,106,467,189,570
bicycle,yolov8x,5021039430_0cda148fd5_z.jpg,640,427,3,1,0.95783788,358,284,55.9375,66.51053864,62,346,253,611
bicycle,yolov8x,5021039430_0cda148fd5_z.jpg,640,427,3,1,0.897858441,141,66,22.03125,15.45667447,360,426,272,413
bicycle,yolov8x,5021039430_0cda148fd5_z.jpg,640,427,3,1,0.878477395,167,112,26.09375,26.2295082,0,112,335,502
bicycle,yolov8x,5021039430_0cda148fd5_z.jpg,640,427,3,1,0.570258856,50,82,7.8125,19.20374707,23,105,303,353
bicycle,yolov8x,9157606630_2ef852a3ee_z.jpg,640,427,3,1,0.911986947,156,227,24.375,53.16159251,122,349,219,375
bicycle,yolov8x,18608021442_84f7dcfa5c_z.jpg,480,640,3,1,0.880263925,154,348,32.08333333,54.375,95,443,226,380
bicycle,yolov8x,159051371_77f7d02bb6_z.jpg,480,640,3,1,0.886554062,474,465,98.75,72.65625,99,564,1,475
bicycle,yolov8x,3666190087_ca2fb0d709_z.jpg,480,640,3,1,0.93416518,354,517,73.75,80.78125,84,601,36,390
bicycle,yolov8x,2788056049_b71f8998c7_z.jpg,640,480,3,1,0.862225235,116,109,18.125,22.70833333,369,478,469,585
bicycle,yolov8x,2788056049_b71f8998c7_z.jpg,640,480,3,1,0.828774929,92,78,14.375,16.25,256,334,380,472
bicycle,yolov8x,2788056049_b71f8998c7_z.jpg,640,480,3,1,0.512151718,63,55,9.84375,11.45833333,189,244,293,356
bicycle,yolov8x,14652913468_5d3b2a39f1_z.jpg,480,640,3,1,0.953856945,400,529,83.33333333,82.65625,9,538,79,479
bicycle,yolov8x,14652913468_5d3b2a39f1_z.jpg,480,640,3,1,0.41549021,113,69,23.54166667,10.78125,427,496,0,113
bicycle,yolov8x,3446761063_9cdc26f36c_z.jpg,426,640,3,1,0.941164672,218,344,51.17370892,53.75,59,403,152,370
bicycle,yolov8x,9688658716_4b3e9c618c_z.jpg,427,640,3,1,0.918829799,177,377,41.45199063,58.90625,262,639,246,423
bicycle,yolov8x,7417962302_a50fc8eb6b_z.jpg,425,640,3,1,0.954524338,159,320,37.41176471,50,202,522,263,422
bicycle,yolov8x,7417962302_a50fc8eb6b_z.jpg,425,640,3,1,0.929818451,90,168,21.17647059,26.25,52,220,193,283
bicycle,yolov8x,7417962302_a50fc8eb6b_z.jpg,425,640,3,1,0.871208966,88,36,20.70588235,5.625,0,36,191,279
bicycle,yolov8x,3685504815_c15a389bd3_z.jpg,480,640,3,1,0.945346534,228,346,47.5,54.0625,146,492,174,402
bicycle,yolov8x,8289650934_506c73242a_z.jpg,612,612,3,1,0.974192381,432,578,70.58823529,94.44444444,16,594,109,541
bicycle,yolov8x,4625462281_7df55484bb_z.jpg,426,640,3,1,0.928853929,405,278,95.07042254,43.4375,4,282,16,421
bicycle,yolov8x,4625462281_7df55484bb_z.jpg,426,640,3,1,0.922482848,288,167,67.6056338,26.09375,371,538,58,346
bicycle,yolov8x,4625462281_7df55484bb_z.jpg,426,640,3,1,0.768209517,119,93,27.9342723,14.53125,547,640,303,422
bicycle,yolov8x,4625462281_7df55484bb_z.jpg,426,640,3,1,0.624059618,298,259,69.95305164,40.46875,177,436,42,340
bicycle,yolov8x,4625462281_7df55484bb_z.jpg,426,640,3,1,0.450369,331,156,77.69953052,24.375,0,156,32,363
bicycle,yolov8x,4625462281_7df55484bb_z.jpg,426,640,3,1,0.375108629,107,139,25.11737089,21.71875,258,397,11,118
bicycle,yolov8x,4625462281_7df55484bb_z.jpg,426,640,3,1,0.348158449,166,43,38.96713615,6.71875,0,43,201,367
bicycle,yolov8x,4625462281_7df55484bb_z.jpg,426,640,3,1,0.271829128,214,161,50.23474178,25.15625,0,161,31,245
bicycle,yolov8x,6771874127_f8f380b3cb_z.jpg,425,640,3,1,0.958316028,418,638,98.35294118,99.6875,1,639,0,418
bicycle,yolov8x,4349979920_189df35e15_z.jpg,480,640,3,1,0.966984928,285,443,59.375,69.21875,148,591,69,354
bicycle,yolov8x,5816846412_7b6fa97da0_z.jpg,427,640,3,1,0.895237267,411,552,96.2529274,86.25,49,601,7,418
bicycle,yolov8x,82903264_5dd277c32d_z.jpg,480,640,3,1,0.913680434,203,221,42.29166667,34.53125,189,410,246,449
bicycle,yolov8x,82903264_5dd277c32d_z.jpg,480,640,3,1,0.906009436,155,159,32.29166667,24.84375,15,174,266,421
bicycle,yolov8x,82903264_5dd277c32d_z.jpg,480,640,3,1,0.515755653,114,95,23.75,14.84375,355,450,251,365
bicycle,yolov8x,2258982401_762044a41d_z.jpg,480,640,3,1,0.92466867,212,349,44.16666667,54.53125,284,633,180,392
bicycle,yolov8x,6141562070_11880edf2e_z.jpg,425,639,3,0,0,0,0,0,0,0,0,0,0
bicycle,yolov8x,5402229494_570e48f7f9_z.jpg,427,640,3,1,0.949627221,291,319,68.1498829,49.84375,0,319,1,292
bicycle,yolov8x,5402229494_570e48f7f9_z.jpg,427,640,3,1,0.786397398,299,495,70.0234192,77.34375,82,577,112,411
bicycle,yolov8x,3715997008_28a251eba7_z.jpg,425,640,3,1,0.84740597,285,371,67.05882353,57.96875,194,565,135,420
bicycle,yolov8x,5877730305_f5e3d13667_z.jpg,427,640,3,1,0.940515041,263,285,61.59250585,44.53125,304,589,124,387
bicycle,yolov8x,15235483580_08696e0988_z.jpg,640,427,3,1,0.911165118,337,190,52.65625,44.49648712,112,302,238,575
bicycle,yolov8x,224422461_dddd4c8e99_z.jpg,480,640,3,1,0.648424625,293,531,61.04166667,82.96875,58,589,161,454
bicycle,yolov8x,224422461_dddd4c8e99_z.jpg,480,640,3,1,0.429035485,274,319,57.08333333,49.84375,264,583,180,454
bicycle,yolov8x,224422461_dddd4c8e99_z.jpg,480,640,3,1,0.268167764,199,348,41.45833333,54.375,58,406,255,454
bicycle,yolov8x,8291522231_19e1414c1b_z.jpg,612,612,3,1,0.923860788,510,534,83.33333333,87.25490196,30,564,25,535
bicycle,yolov8x,16675918410_cc9588a553_z.jpg,359,640,3,0,0,0,0,0,0,0,0,0,0
bicycle,yolov8x,2746929519_3599d54cfb_z.jpg,480,640,3,1,0.879771471,164,72,34.16666667,11.25,0,72,10,174
bicycle,yolov8x,2746929519_3599d54cfb_z.jpg,480,640,3,1,0.717417538,461,564,96.04166667,88.125,4,568,1,462
bicycle,yolov8x,2746929519_3599d54cfb_z.jpg,480,640,3,1,0.307994425,241,281,50.20833333,43.90625,286,567,222,463
bicycle,yolov8x,5708252159_5b4ac86a01_z.jpg,480,640,3,1,0.92128861,118,176,24.58333333,27.5,251,427,0,118
bicycle,yolov8x,5708252159_5b4ac86a01_z.jpg,480,640,3,1,0.910394609,375,530,78.125,82.8125,92,622,105,480
bicycle,yolov8x,5708252159_5b4ac86a01_z.jpg,480,640,3,1,0.362861902,279,236,58.125,36.875,93,329,108,387
bicycle,yolov8x,5708252159_5b4ac86a01_z.jpg,480,640,3,1,0.280708551,156,177,32.5,27.65625,113,290,108,264
bicycle,yolov8x,3353007655_56889b94a7_z.jpg,480,640,3,1,0.923843205,150,81,31.25,12.65625,281,362,224,374
bicycle,yolov8x,14265143426_0770389597_z.jpg,407,640,3,0,0,0,0,0,0,0,0,0,0
bicycle,yolov8x,8651904899_c2632fe751_z.jpg,427,640,3,0,0,0,0,0,0,0,0,0,0
bicycle,yolov8x,1553312291_c0cae48a37_z.jpg,640,287,3,1,0.96633631,158,271,24.6875,94.42508711,8,279,45,203
bicycle,yolov8x,1553312291_c0cae48a37_z.jpg,640,287,3,1,0.950362861,212,143,33.125,49.82578397,0,143,214,426
bicycle,yolov8x,1553312291_c0cae48a37_z.jpg,640,287,3,1,0.94559449,204,104,31.875,36.2369338,162,266,431,635
bicycle,yolov8x,9755183855_953c4f062c_z.jpg,425,640,3,1,0.688237786,130,213,30.58823529,33.28125,229,442,293,423
bicycle,yolov8x,5971377496_abc7d794c7_z.jpg,480,640,3,1,0.959680796,264,270,55,42.1875,111,381,215,479
bicycle,yolov8x,6459633873_5effb4b6e5_z.jpg,426,640,3,1,0.976642847,310,455,72.76995305,71.09375,110,565,93,403
bicycle,yolov8x,11484364375_4180af41fc_z.jpg,427,640,3,1,0.97591269,358,560,83.84074941,87.5,37,597,31,389
bicycle,yolov8x,8106854318_06c1cc0fc3_z.jpg,480,640,3,1,0.973536432,357,633,74.375,98.90625,4,637,60,417
bicycle,yolov8x,296513213_9681371ed9_z.jpg,426,640,3,1,0.908952713,416,631,97.65258216,98.59375,3,634,1,417
bicycle,yolov8x,3747524_f07f508ba9_z.jpg,640,504,3,1,0.459373087,282,340,44.0625,67.46031746,74,414,220,502
bicycle,yolov8x,18068160735_6c2f214265_z.jpg,480,640,3,0,0,0,0,0,0,0,0,0,0
bicycle,yolov8x,9141188655_328b195d8d_z.jpg,427,640,3,1,0.934116066,253,143,59.25058548,22.34375,287,430,165,418
bicycle,yolov8x,21376683791_d98acff014_z.jpg,640,640,3,1,0.965508819,451,559,70.46875,87.34375,19,578,127,578
bicycle,yolov8x,3604271495_1cacccec06_z.jpg,427,640,3,0,0,0,0,0,0,0,0,0,0
bicycle,yolov8x,51712355_49c2e95899_z.jpg,427,640,3,1,0.380485147,142,332,33.25526932,51.875,225,557,169,311
bicycle,yolov8x,7675033952_b3caa0dd37_z.jpg,639,480,3,1,0.952224016,272,281,42.56651017,58.54166667,0,281,313,585
bicycle,yolov8x,14757587416_892a95bf77_z.jpg,360,640,3,1,0.805443883,182,64,50.55555556,10,277,341,175,357
bicycle,yolov8x,14757587416_892a95bf77_z.jpg,360,640,3,1,0.780220568,124,97,34.44444444,15.15625,411,508,233,357
bicycle,yolov8x,2179537346_d695661bbc_z.jpg,640,425,3,1,0.689556718,261,109,40.78125,25.64705882,169,278,332,593
bicycle,yolov8x,2179537346_d695661bbc_z.jpg,640,425,3,1,0.562529862,177,89,27.65625,20.94117647,189,278,416,593
bicycle,yolov8x,14628257582_1ff5e98e4c_z.jpg,400,640,3,0,0,0,0,0,0,0,0,0,0
bicycle,yolov8x,19474810921_d2f23de0fc_z.jpg,480,640,3,0,0,0,0,0,0,0,0,0,0
bicycle,yolov8x,234597792_a9f1e7e7a9_z.jpg,425,639,3,1,0.456947118,75,231,17.64705882,36.15023474,281,512,348,423
bicycle,yolov8x,234597792_a9f1e7e7a9_z.jpg,425,639,3,1,0.388015658,173,157,40.70588235,24.56964006,27,184,246,419
bicycle,yolov8x,234597792_a9f1e7e7a9_z.jpg,425,639,3,1,0.288812906,182,483,42.82352941,75.58685446,27,510,239,421
bicycle,yolov8x,15333662010_2f428f7e2f_z.jpg,480,640,3,1,0.95242697,177,273,36.875,42.65625,1,274,212,389
bicycle,yolov8x,15333662010_2f428f7e2f_z.jpg,480,640,3,1,0.949403584,184,182,38.33333333,28.4375,401,583,212,396
bicycle,yolov8x,15333662010_2f428f7e2f_z.jpg,480,640,3,1,0.645236373,82,85,17.08333333,13.28125,189,274,198,280
bicycle,yolov8x,414586991_9630094229_z.jpg,516,640,3,1,0.911173642,371,460,71.89922481,71.875,159,619,26,397
bicycle,yolov8x,414586991_9630094229_z.jpg,516,640,3,1,0.871248305,490,450,94.96124031,70.3125,36,486,12,502
bicycle,yolov8x,2883059364_a6ccfaf69a_z.jpg,480,640,3,1,0.962996185,307,543,63.95833333,84.84375,58,601,69,376
bicycle,yolov8x,4484760806_dc814d2ce2_z.jpg,640,425,3,1,0.958681047,262,339,40.9375,79.76470588,40,379,272,534
bicycle,yolov8x,6816985831_893d039421_z.jpg,425,640,3,1,0.947618186,360,624,84.70588235,97.5,15,639,58,418
bicycle,yolov8x,14811525368_d8b774e40a_z.jpg,425,640,3,1,0.791977704,174,104,40.94117647,16.25,315,419,206,380
bicycle,yolov8x,14811525368_d8b774e40a_z.jpg,425,640,3,1,0.76723969,97,51,22.82352941,7.96875,283,334,183,280
bicycle,yolov8x,5599702283_8562638984_z.jpg,427,640,3,1,0.979443431,378,529,88.52459016,82.65625,49,578,1,379
bicycle,yolov8x,6076857457_7a06e6ab35_z.jpg,478,640,3,1,0.93946898,141,114,29.49790795,17.8125,514,628,104,245
bicycle,yolov8x,6076857457_7a06e6ab35_z.jpg,478,640,3,1,0.269457996,72,47,15.06276151,7.34375,592,639,118,190
bicycle,yolov8x,1511658057_17b7bac11a_z.jpg,398,640,3,1,0.504578829,136,201,34.17085427,31.40625,432,633,240,376
bicycle,yolov8x,1511658057_17b7bac11a_z.jpg,398,640,3,1,0.381142914,129,190,32.4120603,29.6875,2,192,223,352
bicycle,yolov8x,4065552857_98aa8a39d4_z.jpg,427,640,3,1,0.840657949,203,130,47.54098361,20.3125,41,171,192,395
bicycle,yolov8x,4065552857_98aa8a39d4_z.jpg,427,640,3,1,0.794028342,61,120,14.28571429,18.75,519,639,231,292
bicycle,yolov8x,4065552857_98aa8a39d4_z.jpg,427,640,3,1,0.766954005,110,186,25.76112412,29.0625,275,461,313,423
bicycle,yolov8x,4065552857_98aa8a39d4_z.jpg,427,640,3,1,0.757298768,110,66,25.76112412,10.3125,220,286,204,314
bicycle,yolov8x,9444094315_ba610ed94a_z.jpg,640,441,3,1,0.7675668,322,177,50.3125,40.13605442,179,356,214,536
bicycle,yolov8x,16679943419_b0fd9b6858_z.jpg,427,640,3,1,0.911276698,162,131,37.93911007,20.46875,509,640,237,399
bicycle,yolov8x,16679943419_b0fd9b6858_z.jpg,427,640,3,1,0.876470327,138,118,32.31850117,18.4375,1,119,12,150
bicycle,yolov8x,16679943419_b0fd9b6858_z.jpg,427,640,3,1,0.873308837,159,56,37.23653396,8.75,0,56,25,184
bicycle,yolov8x,16679943419_b0fd9b6858_z.jpg,427,640,3,1,0.869274437,188,117,44.02810304,18.28125,523,640,2,190
bicycle,yolov8x,16679943419_b0fd9b6858_z.jpg,427,640,3,1,0.846098304,143,113,33.48946136,17.65625,0,113,282,425
bicycle,yolov8x,16679943419_b0fd9b6858_z.jpg,427,640,3,1,0.835166693,154,163,36.06557377,25.46875,463,626,193,347
bicycle,yolov8x,16679943419_b0fd9b6858_z.jpg,427,640,3,1,0.828712821,130,121,30.44496487,18.90625,438,559,186,316
bicycle,yolov8x,16679943419_b0fd9b6858_z.jpg,427,640,3,1,0.813435495,114,109,26.69789227,17.03125,108,217,61,175
bicycle,yolov8x,16679943419_b0fd9b6858_z.jpg,427,640,3,1,0.679449201,54,30,12.64637002,4.6875,610,640,370,424
bicycle,yolov8x,16679943419_b0fd9b6858_z.jpg,427,640,3,1,0.623854637,77,77,18.03278689,12.03125,361,438,168,245
bicycle,yolov8x,16679943419_b0fd9b6858_z.jpg,427,640,3,1,0.589639544,166,149,38.87587822,23.28125,489,638,1,167
bicycle,yolov8x,16679943419_b0fd9b6858_z.jpg,427,640,3,1,0.552935243,100,37,23.41920375,5.78125,0,37,323,423
bicycle,yolov8x,16679943419_b0fd9b6858_z.jpg,427,640,3,1,0.518166602,108,96,25.29274005,15,412,508,190,298
bicycle,yolov8x,16679943419_b0fd9b6858_z.jpg,427,640,3,1,0.500301778,53,40,12.41217799,6.25,0,40,196,249
bicycle,yolov8x,16679943419_b0fd9b6858_z.jpg,427,640,3,1,0.498222619,142,184,33.25526932,28.75,1,185,188,330
bicycle,yolov8x,16679943419_b0fd9b6858_z.jpg,427,640,3,1,0.496771693,178,160,41.68618267,25,1,161,190,368
bicycle,yolov8x,16679943419_b0fd9b6858_z.jpg,427,640,3,1,0.477684021,88,76,20.6088993,11.875,424,500,78,166
bicycle,yolov8x,16679943419_b0fd9b6858_z.jpg,427,640,3,1,0.45209232,74,70,17.33021077,10.9375,398,468,196,270
bicycle,yolov8x,16679943419_b0fd9b6858_z.jpg,427,640,3,1,0.417691678,40,36,9.367681499,5.625,216,252,129,169
bicycle,yolov8x,16679943419_b0fd9b6858_z.jpg,427,640,3,1,0.385623753,19,43,4.449648712,6.71875,63,106,231,250
bicycle,yolov8x,16679943419_b0fd9b6858_z.jpg,427,640,3,1,0.359286606,63,61,14.75409836,9.53125,391,452,189,252
bicycle,yolov8x,16679943419_b0fd9b6858_z.jpg,427,640,3,1,0.310916394,40,63,9.367681499,9.84375,277,340,197,237
bicycle,yolov8x,16679943419_b0fd9b6858_z.jpg,427,640,3,1,0.308225363,103,147,24.12177986,22.96875,8,155,266,369
bicycle,yolov8x,16679943419_b0fd9b6858_z.jpg,427,640,3,1,0.291698217,101,107,23.65339578,16.71875,105,212,205,306
bicycle,yolov8x,16679943419_b0fd9b6858_z.jpg,427,640,3,1,0.271862864,84,74,19.67213115,11.5625,413,487,213,297
bicycle,yolov8x,16679943419_b0fd9b6858_z.jpg,427,640,3,1,0.261094481,83,95,19.43793911,14.84375,391,486,183,266
bicycle,yolov8x,16679943419_b0fd9b6858_z.jpg,427,640,3,1,0.260752738,69,87,16.15925059,13.59375,154,241,185,254
bicycle,yolov8x,16679943419_b0fd9b6858_z.jpg,427,640,3,1,0.26011312,53,43,12.41217799,6.71875,382,425,127,180
bicycle,yolov8x,16679943419_b0fd9b6858_z.jpg,427,640,3,1,0.259507596,83,87,19.43793911,13.59375,149,236,194,277
bicycle,yolov8x,3452990622_cfb5fba34a_z.jpg,480,640,3,1,0.915703952,282,203,58.75,31.71875,171,374,163,445
bicycle,yolov8x,3452990622_cfb5fba34a_z.jpg,480,640,3,1,0.90221709,236,282,49.16666667,44.0625,291,573,244,480
bicycle,yolov8x,3452990622_cfb5fba34a_z.jpg,480,640,3,1,0.591246545,98,51,20.41666667,7.96875,130,181,118,216
bicycle,yolov8x,3452990622_cfb5fba34a_z.jpg,480,640,3,1,0.365470439,44,17,9.166666667,2.65625,367,384,99,143
bicycle,yolov8x,3452990622_cfb5fba34a_z.jpg,480,640,3,1,0.319568932,97,97,20.20833333,15.15625,130,227,119,216
bicycle,yolov8x,5877731495_29cc1a6c57_z.jpg,426,640,3,1,0.948121786,235,221,55.16431925,34.53125,224,445,153,388
bicycle,yolov8x,2882148223_72d4df2a8e_z.jpg,480,640,3,1,0.956743777,445,598,92.70833333,93.4375,19,617,28,473
bicycle,yolov8x,6102395478_8c004e1142_z.jpg,480,640,3,1,0.883291483,455,636,94.79166667,99.375,2,638,24,479
bicycle,yolov8x,7548613890_a6272237ac_z.jpg,640,480,3,1,0.96154356,433,434,67.65625,90.41666667,29,463,66,499
bicycle,yolov8x,7548613890_a6272237ac_z.jpg,640,480,3,1,0.877383173,281,238,43.90625,49.58333333,242,480,37,318
bicycle,yolov8x,7548613890_a6272237ac_z.jpg,640,480,3,1,0.832823634,367,131,57.34375,27.29166667,0,131,272,639
bicycle,yolov8x,2784964324_0b0373fd24_z.jpg,480,640,3,1,0.920483887,232,195,48.33333333,30.46875,124,319,177,409
bicycle,yolov8x,8773393046_236298c465_z.jpg,427,640,3,1,0.556150138,217,460,50.81967213,71.875,64,524,1,218
bicycle,yolov8x,14289042367_a041af95f4_z.jpg,427,640,3,1,0.966277421,170,428,39.81264637,66.875,77,505,193,363
bicycle,yolov8x,1229448893_42c357ea12_z.jpg,400,640,3,1,0.9484604,393,355,98.25,55.46875,273,628,1,394
bicycle,yolov8x,5506132265_d6d43548eb_z.jpg,427,640,3,1,0.801580369,391,357,91.56908665,55.78125,238,595,28,419
bicycle,yolov8x,5506132265_d6d43548eb_z.jpg,427,640,3,1,0.757827163,393,607,92.03747073,94.84375,0,607,28,421
bicycle,yolov8x,5506132265_d6d43548eb_z.jpg,427,640,3,1,0.626335621,365,387,85.48009368,60.46875,1,388,55,420
bicycle,yolov8x,6117174227_6e5da0556b_z.jpg,640,427,3,1,0.52580893,154,290,24.0625,67.91569087,128,418,372,526
bicycle,yolov8x,541124874_7247349bb7_z.jpg,640,427,3,1,0.934698939,342,317,53.4375,74.23887588,48,365,283,625
bicycle,yolov8x,541124874_7247349bb7_z.jpg,640,427,3,1,0.890989542,126,94,19.6875,22.01405152,307,401,238,364
bicycle,yolov8x,541124874_7247349bb7_z.jpg,640,427,3,1,0.811565399,107,89,16.71875,20.84309133,221,310,243,350
bicycle,yolov8x,541124874_7247349bb7_z.jpg,640,427,3,1,0.807899177,135,58,21.09375,13.58313817,17,75,261,396
bicycle,yolov8x,541124874_7247349bb7_z.jpg,640,427,3,1,0.470808417,33,28,5.15625,6.557377049,362,390,208,241
bicycle,yolov8x,13368340424_5c1f322f72_z.jpg,480,640,3,1,0.97983849,450,568,93.75,88.75,25,593,29,479
bicycle,yolov8x,4763265058_6c6dbb9abe_z.jpg,427,640,3,1,0.716969728,419,638,98.1264637,99.6875,1,639,2,421
bicycle,yolov8x,4763265058_6c6dbb9abe_z.jpg,427,640,3,1,0.507944763,99,201,23.18501171,31.40625,439,640,24,123
bicycle,yolov8x,4763265058_6c6dbb9abe_z.jpg,427,640,3,1,0.462981403,270,395,63.23185012,61.71875,243,638,10,280
bicycle,yolov8x,4763265058_6c6dbb9abe_z.jpg,427,640,3,1,0.381131798,179,324,41.92037471,50.625,314,638,12,191
bicycle,yolov8x,4763265058_6c6dbb9abe_z.jpg,427,640,3,1,0.358913511,138,233,32.31850117,36.40625,407,640,54,192
bicycle,yolov8x,4763265058_6c6dbb9abe_z.jpg,427,640,3,1,0.31143555,76,186,17.79859485,29.0625,454,640,3,79
bicycle,yolov8x,4763265058_6c6dbb9abe_z.jpg,427,640,3,1,0.308857173,50,181,11.70960187,28.28125,458,639,1,51
bicycle,yolov8x,1908136167_cae3414e7e_z.jpg,428,640,3,1,0.811300039,267,123,62.38317757,19.21875,196,319,18,285
bicycle,yolov8x,1908136167_cae3414e7e_z.jpg,428,640,3,1,0.786447585,274,137,64.01869159,21.40625,471,608,69,343
bicycle,yolov8x,1908136167_cae3414e7e_z.jpg,428,640,3,1,0.73284924,300,101,70.09345794,15.78125,539,640,63,363
bicycle,yolov8x,1908136167_cae3414e7e_z.jpg,428,640,3,1,0.673870027,278,87,64.95327103,13.59375,0,87,42,320
bicycle,yolov8x,1908136167_cae3414e7e_z.jpg,428,640,3,1,0.601038277,369,350,86.21495327,54.6875,40,390,30,399
bicycle,yolov8x,1908136167_cae3414e7e_z.jpg,428,640,3,1,0.496373564,260,73,60.74766355,11.40625,307,380,59,319
bicycle,yolov8x,1908136167_cae3414e7e_z.jpg,428,640,3,1,0.461940587,257,52,60.04672897,8.125,391,443,62,319
bicycle,yolov8x,1908136167_cae3414e7e_z.jpg,428,640,3,1,0.449174911,277,114,64.71962617,17.8125,308,422,56,333
bicycle,yolov8x,1908136167_cae3414e7e_z.jpg,428,640,3,1,0.432040215,220,112,51.40186916,17.5,397,509,43,263
bicycle,yolov8x,1908136167_cae3414e7e_z.jpg,428,640,3,1,0.425330669,346,191,80.8411215,29.84375,1,192,32,378
bicycle,yolov8x,1908136167_cae3414e7e_z.jpg,428,640,3,1,0.377740681,202,279,47.19626168,43.59375,113,392,196,398
bicycle,yolov8x,1908136167_cae3414e7e_z.jpg,428,640,3,1,0.361563146,274,66,64.01869159,10.3125,353,419,57,331
bicycle,yolov8x,1908136167_cae3414e7e_z.jpg,428,640,3,1,0.323208243,242,158,56.54205607,24.6875,41,199,32,274
bicycle,yolov8x,2136213674_4e484d88e3_z.jpg,640,480,3,1,0.958872378,380,366,59.375,76.25,106,472,190,570
car,yolov8l,3141821008_3743fb8be5_z.jpg,494,640,3,1,0.880476415,33,61,6.680161943,9.53125,18,79,198,231
car,yolov8l,3141821008_3743fb8be5_z.jpg,494,640,3,1,0.69729805,21,39,4.251012146,6.09375,578,617,199,220
car,yolov8l,3141821008_3743fb8be5_z.jpg,494,640,3,1,0.673588514,15,30,3.036437247,4.6875,562,592,199,214
car,yolov8l,3141821008_3743fb8be5_z.jpg,494,640,3,1,0.672534227,265,486,53.6437247,75.9375,72,558,185,450
car,yolov8l,5336089950_d2f4618519_z.jpg,384,640,3,1,0.942373157,335,407,87.23958333,63.59375,187,594,10,345
car,yolov8l,2370036280_507a07c953_z.jpg,445,640,3,1,0.96241498,321,461,72.13483146,72.03125,80,541,66,387
car,yolov8l,5007439610_5bb351fc1f_z.jpg,480,640,3,1,0.927715957,145,209,30.20833333,32.65625,194,403,201,346
car,yolov8l,144429519_9567ff4044_z.jpg,425,640,3,1,0.944325745,226,564,53.17647059,88.125,44,608,177,403
car,yolov8l,5763085728_cd042a4cb0_z.jpg,428,640,3,1,0.942616999,240,544,56.07476636,85,28,572,125,365
car,yolov8l,5484042252_37ce385b5f_z.jpg,480,640,3,1,0.942276299,342,511,71.25,79.84375,53,564,85,427
car,yolov8l,15490190390_d64fe16141_z.jpg,426,640,3,1,0.949004352,157,352,36.85446009,55,121,473,131,288
car,yolov8l,15490190390_d64fe16141_z.jpg,426,640,3,1,0.924202621,92,243,21.59624413,37.96875,31,274,65,157
car,yolov8l,10218081326_b6a2dd98f5_z.jpg,640,640,3,1,0.968433619,363,501,56.71875,78.28125,0,501,207,570
car,yolov8l,10218081326_b6a2dd98f5_z.jpg,640,640,3,1,0.880818784,150,83,23.4375,12.96875,449,532,214,364
car,yolov8l,10218081326_b6a2dd98f5_z.jpg,640,640,3,1,0.873520434,29,83,4.53125,12.96875,557,640,211,240
car,yolov8l,10218081326_b6a2dd98f5_z.jpg,640,640,3,1,0.332045108,48,60,7.5,9.375,104,164,237,285
car,yolov8l,4597825116_8ec71a76cf_z.jpg,468,640,3,1,0.959124207,304,627,64.95726496,97.96875,12,639,111,415
car,yolov8l,4597825116_8ec71a76cf_z.jpg,468,640,3,1,0.703847229,53,72,11.32478632,11.25,0,72,202,255
car,yolov8l,48901634_c792cbab58_z.jpg,424,640,3,1,0.893660784,231,311,54.48113208,48.59375,329,640,158,389
car,yolov8l,5516505342_43268015f4_z.jpg,480,640,3,1,0.964063525,205,466,42.70833333,72.8125,81,547,163,368
car,yolov8l,5516505342_43268015f4_z.jpg,480,640,3,1,0.924700141,120,183,25,28.59375,456,639,137,257
car,yolov8l,5516505342_43268015f4_z.jpg,480,640,3,1,0.803504348,36,83,7.5,12.96875,557,640,139,175
car,yolov8l,5516505342_43268015f4_z.jpg,480,640,3,1,0.62659657,20,91,4.166666667,14.21875,289,380,155,175
car,yolov8l,5516505342_43268015f4_z.jpg,480,640,3,1,0.471643716,17,25,3.541666667,3.90625,615,640,138,155
car,yolov8l,5516505342_43268015f4_z.jpg,480,640,3,1,0.470232338,81,164,16.875,25.625,44,208,165,246
car,yolov8l,5516505342_43268015f4_z.jpg,480,640,3,1,0.450984091,42,74,8.75,11.5625,0,74,177,219
car,yolov8l,5516505342_43268015f4_z.jpg,480,640,3,1,0.264301419,73,112,15.20833333,17.5,45,157,172,245
car,yolov8l,17554656478_22dea58ed2_z.jpg,419,640,3,1,0.664855957,249,477,59.42720764,74.53125,115,592,137,386
car,yolov8l,8125475_d0a1063029_z.jpg,480,640,3,1,0.951227725,377,539,78.54166667,84.21875,98,637,102,479
car,yolov8l,8125475_d0a1063029_z.jpg,480,640,3,1,0.909503996,134,137,27.91666667,21.40625,24,161,94,228
car,yolov8l,8125475_d0a1063029_z.jpg,480,640,3,1,0.86928606,29,63,6.041666667,9.84375,529,592,118,147
car,yolov8l,8125475_d0a1063029_z.jpg,480,640,3,1,0.852808893,40,57,8.333333333,8.90625,583,640,109,149
car,yolov8l,8125475_d0a1063029_z.jpg,480,640,3,1,0.838613987,66,37,13.75,5.78125,12,49,105,171
car,yolov8l,8125475_d0a1063029_z.jpg,480,640,3,1,0.765321672,50,47,10.41666667,7.34375,0,47,102,152
car,yolov8l,8125475_d0a1063029_z.jpg,480,640,3,1,0.710706592,22,59,4.583333333,9.21875,420,479,111,133
car,yolov8l,8125475_d0a1063029_z.jpg,480,640,3,1,0.664698482,23,34,4.791666667,5.3125,401,435,107,130
car,yolov8l,8125475_d0a1063029_z.jpg,480,640,3,1,0.630343616,28,32,5.833333333,5,465,497,108,136
car,yolov8l,8125475_d0a1063029_z.jpg,480,640,3,1,0.523753941,32,48,6.666666667,7.5,0,48,85,117
car,yolov8l,8125475_d0a1063029_z.jpg,480,640,3,1,0.399002284,23,36,4.791666667,5.625,375,411,105,128
car,yolov8l,8125475_d0a1063029_z.jpg,480,640,3,1,0.316547185,10,32,2.083333333,5,340,372,102,112
car,yolov8l,8125475_d0a1063029_z.jpg,480,640,3,1,0.290627033,27,15,5.625,2.34375,529,544,115,142
car,yolov8l,2433290346_8482cac895_z.jpg,425,640,3,1,0.942768514,189,502,44.47058824,78.4375,57,559,221,410
car,yolov8l,5490854064_57151abb4f_z.jpg,478,640,3,0,0,0,0,0,0,0,0,0,0
car,yolov8l,8634899263_5ce2555806_z.jpg,425,640,3,1,0.958738804,305,490,71.76470588,76.5625,124,614,96,401
car,yolov8l,750912399_32f415ecb1_z.jpg,477,640,3,1,0.775123715,54,49,11.32075472,7.65625,358,407,46,100
car,yolov8l,3595778703_d3bec2f74e_z.jpg,640,479,3,0,0,0,0,0,0,0,0,0,0
car,yolov8l,8265517869_53c5fb3eff_z.jpg,426,639,3,1,0.940790117,306,297,71.83098592,46.47887324,1,298,69,375
car,yolov8l,16982913298_aa90f2a62b_z.jpg,640,640,3,1,0.956264019,341,639,53.28125,99.84375,0,639,153,494
car,yolov8l,16982913298_aa90f2a62b_z.jpg,640,640,3,1,0.892980397,94,98,14.6875,15.3125,0,98,146,240
car,yolov8l,16982913298_aa90f2a62b_z.jpg,640,640,3,1,0.836446822,91,112,14.21875,17.5,528,640,131,222
car,yolov8l,16982913298_aa90f2a62b_z.jpg,640,640,3,1,0.724129617,35,62,5.46875,9.6875,3,65,140,175
car,yolov8l,16982913298_aa90f2a62b_z.jpg,640,640,3,1,0.65115726,58,156,9.0625,24.375,61,217,138,196
car,yolov8l,4370423313_49f3722e85_z.jpg,480,640,3,1,0.934682488,308,559,64.16666667,87.34375,59,618,114,422
car,yolov8l,8032610600_1dd81d41a4_z.jpg,427,640,3,1,0.93594557,384,312,89.92974239,48.75,0,312,6,390
car,yolov8l,82706249_bf54b24c4e_z.jpg,257,639,3,1,0.962267578,213,564,82.87937743,88.2629108,28,592,21,234
car,yolov8l,340359612_df41037e73_z.jpg,426,640,3,1,0.841834605,94,77,22.0657277,12.03125,76,153,120,214
car,yolov8l,340359612_df41037e73_z.jpg,426,640,3,1,0.66922003,175,108,41.07981221,16.875,0,108,82,257
car,yolov8l,340359612_df41037e73_z.jpg,426,640,3,1,0.423084974,83,87,19.48356808,13.59375,553,640,145,228
car,yolov8l,340359612_df41037e73_z.jpg,426,640,3,1,0.357091635,97,108,22.76995305,16.875,0,108,160,257
car,yolov8l,340359612_df41037e73_z.jpg,426,640,3,1,0.253886312,49,51,11.50234742,7.96875,295,346,112,161
car,yolov8l,432591931_4789d0f0f1_z.jpg,480,640,3,1,0.933164239,150,188,31.25,29.375,452,640,118,268
car,yolov8l,432591931_4789d0f0f1_z.jpg,480,640,3,1,0.896537185,140,104,29.16666667,16.25,0,104,165,305
car,yolov8l,432591931_4789d0f0f1_z.jpg,480,640,3,1,0.794116139,156,327,32.5,51.09375,114,441,125,281
car,yolov8l,432591931_4789d0f0f1_z.jpg,480,640,3,1,0.250686198,27,40,5.625,6.25,201,241,145,172
car,yolov8l,6168484879_e6b9644722_z.jpg,427,640,3,1,0.972385705,256,539,59.95316159,84.21875,76,615,94,350
car,yolov8l,6410065163_fef2877544_z.jpg,444,640,3,1,0.929167509,335,596,75.45045045,93.125,44,640,62,397
car,yolov8l,6410065163_fef2877544_z.jpg,444,640,3,1,0.299527109,114,42,25.67567568,6.5625,598,640,120,234
car,yolov8l,953262953_340a098204_z.jpg,427,640,3,1,0.940671563,221,624,51.75644028,97.5,1,625,201,422
car,yolov8l,15038212434_9e0e575008_z.jpg,640,640,3,1,0.939963222,217,492,33.90625,76.875,148,640,223,440
car,yolov8l,5099996575_32762aeb7f_z.jpg,480,640,3,1,0.90562892,398,537,82.91666667,83.90625,71,608,47,445
car,yolov8l,342659307_d5d9d36af5_z.jpg,302,640,3,1,0.939360976,187,633,61.9205298,98.90625,1,634,108,295
car,yolov8l,3312304999_bc296f3260_z.jpg,369,639,3,1,0.866538405,269,622,72.899729,97.33959311,0,622,57,326
car,yolov8l,13340204053_873cda4cef_z.jpg,359,639,3,1,0.88522917,247,560,68.80222841,87.63693271,38,598,40,287
car,yolov8l,5340010485_edeaa88c83_z.jpg,480,639,3,1,0.937752128,264,477,55,74.64788732,37,514,119,383
car,yolov8l,5340010485_edeaa88c83_z.jpg,480,639,3,1,0.935004711,160,194,33.33333333,30.3599374,445,639,94,254
car,yolov8l,5340010485_edeaa88c83_z.jpg,480,639,3,1,0.598419726,45,28,9.375,4.381846635,0,28,99,144
car,yolov8l,2525539133_73f08a9471_z.jpg,427,640,3,1,0.944128394,174,444,40.74941452,69.375,156,600,183,357
car,yolov8l,6431153899_9ac59a36b4_z.jpg,480,640,3,1,0.948242128,247,548,51.45833333,85.625,51,599,200,447
car,yolov8l,16106543870_2f167db1e1_z.jpg,480,640,3,1,0.786768258,276,630,57.5,98.4375,1,631,107,383
car,yolov8l,19577109682_a0282d8678_z.jpg,458,640,3,1,0.868131757,263,592,57.42358079,92.5,16,608,109,372
car,yolov8l,6010263871_df93fb6382_z.jpg,427,640,3,1,0.944992959,158,328,37.00234192,51.25,1,329,135,293
car,yolov8l,6010263871_df93fb6382_z.jpg,427,640,3,1,0.930810571,140,160,32.78688525,25,480,640,141,281
car,yolov8l,6010263871_df93fb6382_z.jpg,427,640,3,1,0.882767141,113,272,26.46370023,42.5,307,579,97,210
car,yolov8l,6010263871_df93fb6382_z.jpg,427,640,3,1,0.867631912,81,165,18.96955504,25.78125,9,174,117,198
car,yolov8l,6010263871_df93fb6382_z.jpg,427,640,3,1,0.486059099,20,13,4.683840749,2.03125,0,13,0,20
car,yolov8l,6010263871_df93fb6382_z.jpg,427,640,3,1,0.385653555,18,61,4.215456674,9.53125,402,463,0,18
car,yolov8l,7110476047_267467ee68_z.jpg,450,640,3,1,0.899150729,72,109,16,17.03125,20,129,177,249
car,yolov8l,7110476047_267467ee68_z.jpg,450,640,3,1,0.869400024,66,77,14.66666667,12.03125,563,640,154,220
car,yolov8l,7110476047_267467ee68_z.jpg,450,640,3,1,0.823391557,95,94,21.11111111,14.6875,537,631,164,259
car,yolov8l,7110476047_267467ee68_z.jpg,450,640,3,1,0.816403806,319,473,70.88888889,73.90625,92,565,88,407
car,yolov8l,7035751851_15d745cf2c_z.jpg,480,640,3,1,0.958675683,264,571,55,89.21875,47,618,109,373
car,yolov8l,7035751851_15d745cf2c_z.jpg,480,640,3,1,0.939247251,158,279,32.91666667,43.59375,0,279,101,259
car,yolov8l,7035751851_15d745cf2c_z.jpg,480,640,3,1,0.740501165,54,98,11.25,15.3125,0,98,101,155
car,yolov8l,7035751851_15d745cf2c_z.jpg,480,640,3,1,0.429779798,31,19,6.458333333,2.96875,541,560,61,92
car,yolov8l,3157735385_c9e7580f03_z.jpg,471,640,3,1,0.948751867,221,638,46.92144374,99.6875,0,638,229,450
car,yolov8l,3679100484_a8e3044e55_z.jpg,480,640,3,1,0.947897673,182,595,37.91666667,92.96875,18,613,149,331
car,yolov8l,9238365388_d2bb1bb2e4_z.jpg,424,640,3,1,0.965811193,367,573,86.55660377,89.53125,1,574,6,373
car,yolov8l,9238365388_d2bb1bb2e4_z.jpg,424,640,3,1,0.933863699,211,467,49.76415094,72.96875,172,639,41,252
car,yolov8l,9238365388_d2bb1bb2e4_z.jpg,424,640,3,1,0.860085487,69,107,16.27358491,16.71875,533,640,58,127
car,yolov8l,14786765330_5d381d2451_z.jpg,480,640,3,1,0.963208377,315,556,65.625,86.875,37,593,103,418
car,yolov8l,14786765330_5d381d2451_z.jpg,480,640,3,1,0.732287288,26,39,5.416666667,6.09375,250,289,129,155
car,yolov8l,14786765330_5d381d2451_z.jpg,480,640,3,1,0.625208855,42,17,8.75,2.65625,623,640,176,218
car,yolov8l,14786765330_5d381d2451_z.jpg,480,640,3,1,0.342077494,122,46,25.41666667,7.1875,0,46,99,221
car,yolov8l,14786765330_5d381d2451_z.jpg,480,640,3,1,0.317574233,74,94,15.41666667,14.6875,111,205,95,169
car,yolov8l,20795376805_7d3aabfce1_z.jpg,400,640,3,1,0.95083493,196,390,49,60.9375,103,493,133,329
car,yolov8l,9057859369_5a432fdfe1_z.jpg,427,640,3,1,0.953779817,313,518,73.30210773,80.9375,50,568,68,381
car,yolov8l,9057859369_5a432fdfe1_z.jpg,427,640,3,1,0.921671689,152,169,35.5971897,26.40625,471,640,25,177
car,yolov8l,9549882142_c59c04bac0_z.jpg,379,600,3,1,0.955162764,259,241,68.33773087,40.16666667,0,241,89,348
car,yolov8l,9549882142_c59c04bac0_z.jpg,379,600,3,1,0.937451422,243,191,64.11609499,31.83333333,409,600,73,316
car,yolov8l,9549882142_c59c04bac0_z.jpg,379,600,3,1,0.917586923,182,152,48.02110818,25.33333333,140,292,106,288
car,yolov8l,9549882142_c59c04bac0_z.jpg,379,600,3,1,0.911454797,194,93,51.18733509,15.5,367,460,95,289
car,yolov8l,5575004957_c281c5de1f_z.jpg,480,640,3,1,0.923304558,318,534,66.25,83.4375,52,586,111,429
car,yolov8l,5575004957_c281c5de1f_z.jpg,480,640,3,1,0.601577222,152,138,31.66666667,21.5625,502,640,118,270
car,yolov8l,2468082692_49ec682990_z.jpg,480,640,3,0,0,0,0,0,0,0,0,0,0
car,yolov8l,5466970559_0f7b06bcd6_z.jpg,427,640,3,1,0.958158553,376,593,88.05620609,92.65625,30,623,29,405
car,yolov8l,5466970559_0f7b06bcd6_z.jpg,427,640,3,1,0.736091316,76,117,17.79859485,18.28125,1,118,0,76
car,yolov8l,5466970559_0f7b06bcd6_z.jpg,427,640,3,1,0.734677196,119,57,27.86885246,8.90625,583,640,101,220
car,yolov8l,5466970559_0f7b06bcd6_z.jpg,427,640,3,1,0.590907156,21,19,4.918032787,2.96875,621,640,83,104
car,yolov8l,5466970559_0f7b06bcd6_z.jpg,427,640,3,1,0.502794504,33,62,7.728337237,9.6875,572,634,86,119
car,yolov8l,5466970559_0f7b06bcd6_z.jpg,427,640,3,1,0.43414253,38,45,8.899297424,7.03125,560,605,96,134
car,yolov8l,5466970559_0f7b06bcd6_z.jpg,427,640,3,1,0.393608719,117,51,27.40046838,7.96875,0,51,138,255
car,yolov8l,5466970559_0f7b06bcd6_z.jpg,427,640,3,1,0.294872284,19,60,4.449648712,9.375,573,633,86,105
car,yolov8l,2918687630_5108e3e2ab_z.jpg,427,640,3,1,0.571659207,33,95,7.728337237,14.84375,367,462,205,238
car,yolov8l,5333910985_ea4e62f651_z.jpg,480,640,3,1,0.34391883,473,637,98.54166667,99.53125,1,638,6,479
car,yolov8l,211850545_7f670901ab_z.jpg,426,640,3,1,0.553019702,417,629,97.88732394,98.28125,5,634,2,419
car,yolov8l,3499391979_76c0c01a3c_z.jpg,427,640,3,1,0.94451201,118,301,27.63466042,47.03125,84,385,245,363
car,yolov8l,6097504753_2971a9eaa6_z.jpg,480,640,3,1,0.853172541,260,460,54.16666667,71.875,71,531,56,316
car,yolov8l,6097504753_2971a9eaa6_z.jpg,480,640,3,1,0.84360075,371,324,77.29166667,50.625,0,324,97,468
car,yolov8l,6097504753_2971a9eaa6_z.jpg,480,640,3,1,0.772314787,146,387,30.41666667,60.46875,236,623,33,179
car,yolov8l,2166320847_63a04a9303_z.jpg,427,640,3,0,0,0,0,0,0,0,0,0,0
car,yolov8l,19299023856_077e45c472_z.jpg,407,639,3,1,0.793079615,114,96,28.00982801,15.02347418,543,639,56,170
car,yolov8l,19299023856_077e45c472_z.jpg,407,639,3,1,0.791374207,271,536,66.58476658,83.88106416,45,581,70,341
car,yolov8l,3413987789_b607473327_z.jpg,480,640,3,1,0.883033872,48,76,10,11.875,564,640,128,176
car,yolov8l,3413987789_b607473327_z.jpg,480,640,3,1,0.691120327,17,12,3.541666667,1.875,0,12,126,143
car,yolov8l,13314143603_95d63b5748_z.jpg,480,640,3,1,0.829259157,79,208,16.45833333,32.5,31,239,70,149
car,yolov8l,13314143603_95d63b5748_z.jpg,480,640,3,1,0.686491132,49,17,10.20833333,2.65625,623,640,90,139
car,yolov8l,13314143603_95d63b5748_z.jpg,480,640,3,1,0.675592959,53,107,11.04166667,16.71875,234,341,71,124
car,yolov8l,13314143603_95d63b5748_z.jpg,480,640,3,1,0.622264326,396,559,82.5,87.34375,65,624,63,459
car,yolov8l,13314143603_95d63b5748_z.jpg,480,640,3,1,0.552976429,46,40,9.583333333,6.25,600,640,75,121
car,yolov8l,7782123174_dbda292cef_z.jpg,480,640,3,1,0.884810686,128,97,26.66666667,15.15625,543,640,215,343
car,yolov8l,15196353300_2dcb1a1948_z.jpg,426,640,3,1,0.91958338,218,331,51.17370892,51.71875,142,473,116,334
car,yolov8l,15196353300_2dcb1a1948_z.jpg,426,640,3,1,0.867020786,23,67,5.399061033,10.46875,543,610,111,134
car,yolov8l,15196353300_2dcb1a1948_z.jpg,426,640,3,1,0.708170891,17,18,3.990610329,2.8125,0,18,112,129
car,yolov8l,15196353300_2dcb1a1948_z.jpg,426,640,3,1,0.665583372,154,163,36.15023474,25.46875,0,163,128,282
car,yolov8l,15196353300_2dcb1a1948_z.jpg,426,640,3,1,0.519082904,14,60,3.286384977,9.375,328,388,108,122
car,yolov8m,3141821008_3743fb8be5_z.jpg,494,640,3,1,0.882516026,32,60,6.477732794,9.375,18,78,198,230
car,yolov8m,3141821008_3743fb8be5_z.jpg,494,640,3,1,0.627498686,15,29,3.036437247,4.53125,563,592,199,214
car,yolov8m,3141821008_3743fb8be5_z.jpg,494,640,3,1,0.620956957,21,40,4.251012146,6.25,578,618,199,220
car,yolov8m,3141821008_3743fb8be5_z.jpg,494,640,3,1,0.513684571,24,48,4.858299595,7.5,516,564,193,217
car,yolov8m,3141821008_3743fb8be5_z.jpg,494,640,3,1,0.315533906,262,446,53.03643725,69.6875,112,558,186,448
car,yolov8m,5336089950_d2f4618519_z.jpg,384,640,3,1,0.835102439,331,406,86.19791667,63.4375,188,594,11,342
car,yolov8m,2370036280_507a07c953_z.jpg,445,640,3,1,0.941188693,320,461,71.91011236,72.03125,80,541,66,386
car,yolov8m,5007439610_5bb351fc1f_z.jpg,480,640,3,1,0.910294235,145,200,30.20833333,31.25,203,403,201,346
car,yolov8m,144429519_9567ff4044_z.jpg,425,640,3,1,0.896178186,225,562,52.94117647,87.8125,46,608,177,402
car,yolov8m,5763085728_cd042a4cb0_z.jpg,428,640,3,1,0.940883398,239,542,55.8411215,84.6875,30,572,125,364
car,yolov8m,5484042252_37ce385b5f_z.jpg,480,640,3,1,0.927801728,345,510,71.875,79.6875,54,564,82,427
car,yolov8m,15490190390_d64fe16141_z.jpg,426,640,3,1,0.945837379,156,351,36.61971831,54.84375,121,472,132,288
car,yolov8m,15490190390_d64fe16141_z.jpg,426,640,3,1,0.928926826,91,242,21.36150235,37.8125,31,273,65,156
car,yolov8m,10218081326_b6a2dd98f5_z.jpg,640,640,3,1,0.964790106,364,502,56.875,78.4375,1,503,206,570
car,yolov8m,10218081326_b6a2dd98f5_z.jpg,640,640,3,1,0.862371564,152,81,23.75,12.65625,451,532,213,365
car,yolov8m,10218081326_b6a2dd98f5_z.jpg,640,640,3,1,0.744784296,28,70,4.375,10.9375,558,628,210,238
car,yolov8m,10218081326_b6a2dd98f5_z.jpg,640,640,3,1,0.261835158,50,62,7.8125,9.6875,103,165,235,285
car,yolov8m,4597825116_8ec71a76cf_z.jpg,468,640,3,1,0.957803607,304,631,64.95726496,98.59375,6,637,111,415
car,yolov8m,4597825116_8ec71a76cf_z.jpg,468,640,3,1,0.627338171,53,70,11.32478632,10.9375,0,70,202,255
car,yolov8m,4597825116_8ec71a76cf_z.jpg,468,640,3,1,0.312399358,47,26,10.04273504,4.0625,0,26,208,255
car,yolov8m,4597825116_8ec71a76cf_z.jpg,468,640,3,1,0.27028358,75,18,16.02564103,2.8125,622,640,197,272
car,yolov8m,48901634_c792cbab58_z.jpg,424,640,3,1,0.918403566,228,310,53.77358491,48.4375,329,639,158,386
car,yolov8m,5516505342_43268015f4_z.jpg,480,640,3,1,0.960290909,205,465,42.70833333,72.65625,81,546,163,368
car,yolov8m,5516505342_43268015f4_z.jpg,480,640,3,1,0.777021527,35,81,7.291666667,12.65625,559,640,138,173
car,yolov8m,5516505342_43268015f4_z.jpg,480,640,3,1,0.731305063,120,217,25,33.90625,423,640,137,257
car,yolov8m,5516505342_43268015f4_z.jpg,480,640,3,1,0.502442896,23,94,4.791666667,14.6875,286,380,154,177
car,yolov8m,5516505342_43268015f4_z.jpg,480,640,3,1,0.396244317,98,114,20.41666667,17.8125,41,155,171,269
car,yolov8m,5516505342_43268015f4_z.jpg,480,640,3,1,0.364602357,99,164,20.625,25.625,41,205,168,267
car,yolov8m,5516505342_43268015f4_z.jpg,480,640,3,1,0.322814286,17,24,3.541666667,3.75,616,640,138,155
car,yolov8m,5516505342_43268015f4_z.jpg,480,640,3,1,0.281460136,55,72,11.45833333,11.25,0,72,177,232
car,yolov8m,17554656478_22dea58ed2_z.jpg,419,640,3,1,0.795320928,251,478,59.90453461,74.6875,115,593,137,388
car,yolov8m,8125475_d0a1063029_z.jpg,480,640,3,1,0.953518629,377,537,78.54166667,83.90625,100,637,102,479
car,yolov8m,8125475_d0a1063029_z.jpg,480,640,3,1,0.893805504,133,135,27.70833333,21.09375,25,160,94,227
car,yolov8m,8125475_d0a1063029_z.jpg,480,640,3,1,0.835722506,30,62,6.25,9.6875,530,592,117,147
car,yolov8m,8125475_d0a1063029_z.jpg,480,640,3,1,0.834149539,42,57,8.75,8.90625,583,640,108,150
car,yolov8m,8125475_d0a1063029_z.jpg,480,640,3,1,0.791022599,50,47,10.41666667,7.34375,0,47,101,151
car,yolov8m,8125475_d0a1063029_z.jpg,480,640,3,1,0.752010882,66,37,13.75,5.78125,12,49,104,170
car,yolov8m,8125475_d0a1063029_z.jpg,480,640,3,1,0.717548788,23,42,4.791666667,6.5625,393,435,107,130
car,yolov8m,8125475_d0a1063029_z.jpg,480,640,3,1,0.688607156,22,54,4.583333333,8.4375,420,474,112,134
car,yolov8m,8125475_d0a1063029_z.jpg,480,640,3,1,0.685191214,28,32,5.833333333,5,465,497,108,136
car,yolov8m,8125475_d0a1063029_z.jpg,480,640,3,1,0.617030025,24,47,5,7.34375,0,47,86,110
car,yolov8m,8125475_d0a1063029_z.jpg,480,640,3,1,0.394794881,31,53,6.458333333,8.28125,490,543,114,145
car,yolov8m,8125475_d0a1063029_z.jpg,480,640,3,1,0.251019508,10,31,2.083333333,4.84375,340,371,102,112
car,yolov8m,2433290346_8482cac895_z.jpg,425,640,3,1,0.94118166,187,503,44,78.59375,58,561,221,408
car,yolov8m,5490854064_57151abb4f_z.jpg,478,640,3,0,0,0,0,0,0,0,0,0,0
car,yolov8m,8634899263_5ce2555806_z.jpg,425,640,3,1,0.958926558,304,489,71.52941176,76.40625,124,613,96,400
car,yolov8m,750912399_32f415ecb1_z.jpg,477,640,3,1,0.854640007,54,49,11.32075472,7.65625,358,407,46,100
car,yolov8m,750912399_32f415ecb1_z.jpg,477,640,3,1,0.586628735,466,636,97.69392034,99.375,2,638,3,469
car,yolov8m,3595778703_d3bec2f74e_z.jpg,640,479,3,0,0,0,0,0,0,0,0,0,0
car,yolov8m,8265517869_53c5fb3eff_z.jpg,426,639,3,1,0.912165642,307,298,72.0657277,46.63536776,1,299,69,376
car,yolov8m,16982913298_aa90f2a62b_z.jpg,640,640,3,1,0.937851906,339,635,52.96875,99.21875,4,639,152,491
car,yolov8m,16982913298_aa90f2a62b_z.jpg,640,640,3,1,0.910779178,93,99,14.53125,15.46875,0,99,146,239
car,yolov8m,16982913298_aa90f2a62b_z.jpg,640,640,3,1,0.870816886,88,111,13.75,17.34375,528,639,132,220
car,yolov8m,16982913298_aa90f2a62b_z.jpg,640,640,3,1,0.787283957,60,159,9.375,24.84375,65,224,137,197
car,yolov8m,16982913298_aa90f2a62b_z.jpg,640,640,3,1,0.746791542,32,59,5,9.21875,2,61,141,173
car,yolov8m,4370423313_49f3722e85_z.jpg,480,640,3,1,0.947118759,310,563,64.58333333,87.96875,57,620,113,423
car,yolov8m,8032610600_1dd81d41a4_z.jpg,427,640,3,1,0.890975773,338,310,79.15690867,48.4375,1,311,52,390
car,yolov8m,82706249_bf54b24c4e_z.jpg,257,639,3,1,0.925650835,214,558,83.26848249,87.32394366,33,591,20,234
car,yolov8m,340359612_df41037e73_z.jpg,426,640,3,1,0.615126312,174,108,40.84507042,16.875,0,108,82,256
car,yolov8m,340359612_df41037e73_z.jpg,426,640,3,1,0.523745358,95,73,22.30046948,11.40625,78,151,118,213
car,yolov8m,340359612_df41037e73_z.jpg,426,640,3,1,0.405900449,86,86,20.18779343,13.4375,554,640,142,228
car,yolov8m,340359612_df41037e73_z.jpg,426,640,3,1,0.353322655,93,109,21.83098592,17.03125,0,109,164,257
car,yolov8m,432591931_4789d0f0f1_z.jpg,480,640,3,1,0.937762082,149,187,31.04166667,29.21875,453,640,119,268
car,yolov8m,432591931_4789d0f0f1_z.jpg,480,640,3,1,0.911623776,138,105,28.75,16.40625,0,105,165,303
car,yolov8m,432591931_4789d0f0f1_z.jpg,480,640,3,1,0.648854613,155,327,32.29166667,51.09375,114,441,125,280
car,yolov8m,6168484879_e6b9644722_z.jpg,427,640,3,1,0.957175314,256,541,59.95316159,84.53125,75,616,94,350
car,yolov8m,6410065163_fef2877544_z.jpg,444,640,3,1,0.915512443,336,596,75.67567568,93.125,44,640,62,398
car,yolov8m,953262953_340a098204_z.jpg,427,640,3,1,0.93045789,221,624,51.75644028,97.5,1,625,201,422
car,yolov8m,15038212434_9e0e575008_z.jpg,640,640,3,1,0.92877847,215,492,33.59375,76.875,148,640,223,438
car,yolov8m,5099996575_32762aeb7f_z.jpg,480,640,3,1,0.938452065,383,535,79.79166667,83.59375,72,607,50,433
car,yolov8m,342659307_d5d9d36af5_z.jpg,302,640,3,1,0.92594856,188,635,62.25165563,99.21875,2,637,108,296
car,yolov8m,3312304999_bc296f3260_z.jpg,369,639,3,1,0.872442603,269,619,72.899729,96.87010955,1,620,56,325
car,yolov8m,13340204053_873cda4cef_z.jpg,359,639,3,1,0.912782371,249,562,69.35933148,87.94992175,37,599,39,288
car,yolov8m,5340010485_edeaa88c83_z.jpg,480,639,3,1,0.92926693,160,193,33.33333333,30.20344288,446,639,94,254
car,yolov8m,5340010485_edeaa88c83_z.jpg,480,639,3,1,0.925128996,263,478,54.79166667,74.80438185,37,515,119,382
car,yolov8m,5340010485_edeaa88c83_z.jpg,480,639,3,1,0.653972983,44,28,9.166666667,4.381846635,0,28,99,143
car,yolov8m,2525539133_73f08a9471_z.jpg,427,640,3,1,0.95894587,173,443,40.51522248,69.21875,157,600,184,357
car,yolov8m,6431153899_9ac59a36b4_z.jpg,480,640,3,1,0.944470644,249,557,51.875,87.03125,50,607,198,447
car,yolov8m,16106543870_2f167db1e1_z.jpg,480,640,3,1,0.655775607,275,635,57.29166667,99.21875,1,636,109,384
car,yolov8m,19577109682_a0282d8678_z.jpg,458,640,3,1,0.897857189,264,592,57.6419214,92.5,16,608,108,372
car,yolov8m,6010263871_df93fb6382_z.jpg,427,640,3,1,0.935792506,158,330,37.00234192,51.5625,0,330,134,292
car,yolov8m,6010263871_df93fb6382_z.jpg,427,640,3,1,0.87304908,77,165,18.03278689,25.78125,9,174,121,198
car,yolov8m,6010263871_df93fb6382_z.jpg,427,640,3,1,0.789424121,140,158,32.78688525,24.6875,481,639,141,281
car,yolov8m,6010263871_df93fb6382_z.jpg,427,640,3,1,0.786615372,117,274,27.40046838,42.8125,307,581,93,210
car,yolov8m,6010263871_df93fb6382_z.jpg,427,640,3,1,0.434241593,18,55,4.215456674,8.59375,401,456,0,18
car,yolov8m,6010263871_df93fb6382_z.jpg,427,640,3,1,0.34922117,13,36,3.044496487,5.625,367,403,0,13
car,yolov8m,6010263871_df93fb6382_z.jpg,427,640,3,1,0.3310211,18,55,4.215456674,8.59375,147,202,0,18
car,yolov8m,6010263871_df93fb6382_z.jpg,427,640,3,1,0.302797616,18,51,4.215456674,7.96875,192,243,0,18
car,yolov8m,6010263871_df93fb6382_z.jpg,427,640,3,1,0.294063091,20,13,4.683840749,2.03125,0,13,0,20
car,yolov8m,7110476047_267467ee68_z.jpg,450,640,3,1,0.915165186,72,110,16,17.1875,20,130,177,249
car,yolov8m,7110476047_267467ee68_z.jpg,450,640,3,1,0.835196376,98,97,21.77777778,15.15625,535,632,164,262
car,yolov8m,7110476047_267467ee68_z.jpg,450,640,3,1,0.80485487,66,74,14.66666667,11.5625,565,639,153,219
car,yolov8m,7110476047_267467ee68_z.jpg,450,640,3,1,0.79894489,313,471,69.55555556,73.59375,93,564,90,403
car,yolov8m,7035751851_15d745cf2c_z.jpg,480,640,3,1,0.952131927,264,568,55,88.75,49,617,109,373
car,yolov8m,7035751851_15d745cf2c_z.jpg,480,640,3,1,0.938657999,159,279,33.125,43.59375,0,279,101,260
car,yolov8m,7035751851_15d745cf2c_z.jpg,480,640,3,1,0.409714431,54,123,11.25,19.21875,0,123,99,153
car,yolov8m,3157735385_c9e7580f03_z.jpg,471,640,3,1,0.934312999,220,635,46.70912951,99.21875,0,635,229,449
car,yolov8m,3679100484_a8e3044e55_z.jpg,480,640,3,1,0.869432688,182,594,37.91666667,92.8125,17,611,150,332
car,yolov8m,9238365388_d2bb1bb2e4_z.jpg,424,640,3,1,0.958855391,364,571,85.8490566,89.21875,2,573,8,372
car,yolov8m,9238365388_d2bb1bb2e4_z.jpg,424,640,3,1,0.891641915,210,465,49.52830189,72.65625,175,640,38,248
car,yolov8m,9238365388_d2bb1bb2e4_z.jpg,424,640,3,1,0.830704927,67,108,15.80188679,16.875,532,640,58,125
car,yolov8m,14786765330_5d381d2451_z.jpg,480,640,3,1,0.963226318,314,557,65.41666667,87.03125,36,593,105,419
car,yolov8m,14786765330_5d381d2451_z.jpg,480,640,3,1,0.721659958,42,16,8.75,2.5,624,640,175,217
car,yolov8m,14786765330_5d381d2451_z.jpg,480,640,3,1,0.715804636,26,40,5.416666667,6.25,249,289,129,155
car,yolov8m,20795376805_7d3aabfce1_z.jpg,400,640,3,1,0.855446041,194,389,48.5,60.78125,103,492,135,329
car,yolov8m,9057859369_5a432fdfe1_z.jpg,427,640,3,1,0.963551819,314,519,73.53629977,81.09375,49,568,68,382
car,yolov8m,9057859369_5a432fdfe1_z.jpg,427,640,3,1,0.883102357,152,169,35.5971897,26.40625,471,640,25,177
car,yolov8m,9057859369_5a432fdfe1_z.jpg,427,640,3,1,0.433585405,27,42,6.323185012,6.5625,215,257,0,27
car,yolov8m,9549882142_c59c04bac0_z.jpg,379,600,3,1,0.9263677,231,197,60.94986807,32.83333333,403,600,85,316
car,yolov8m,9549882142_c59c04bac0_z.jpg,379,600,3,1,0.925434649,193,95,50.92348285,15.83333333,365,460,95,288
car,yolov8m,9549882142_c59c04bac0_z.jpg,379,600,3,1,0.922916651,255,241,67.2823219,40.16666667,1,242,93,348
car,yolov8m,9549882142_c59c04bac0_z.jpg,379,600,3,1,0.901177287,184,157,48.54881266,26.16666667,135,292,105,289
car,yolov8m,5575004957_c281c5de1f_z.jpg,480,640,3,1,0.926048458,319,535,66.45833333,83.59375,52,587,111,430
car,yolov8m,5575004957_c281c5de1f_z.jpg,480,640,3,1,0.771147966,151,138,31.45833333,21.5625,502,640,119,270
car,yolov8m,2468082692_49ec682990_z.jpg,480,640,3,0,0,0,0,0,0,0,0,0,0
car,yolov8m,5466970559_0f7b06bcd6_z.jpg,427,640,3,1,0.951391041,374,597,87.58782201,93.28125,23,620,30,404
car,yolov8m,5466970559_0f7b06bcd6_z.jpg,427,640,3,1,0.842110515,76,117,17.79859485,18.28125,0,117,0,76
car,yolov8m,5466970559_0f7b06bcd6_z.jpg,427,640,3,1,0.520471692,20,62,4.683840749,9.6875,571,633,85,105
car,yolov8m,5466970559_0f7b06bcd6_z.jpg,427,640,3,1,0.518717647,124,78,29.03981265,12.1875,561,639,96,220
car,yolov8m,5466970559_0f7b06bcd6_z.jpg,427,640,3,1,0.485665232,120,56,28.1030445,8.75,584,640,101,221
car,yolov8m,5466970559_0f7b06bcd6_z.jpg,427,640,3,1,0.410706341,40,46,9.367681499,7.1875,560,606,95,135
car,yolov8m,5466970559_0f7b06bcd6_z.jpg,427,640,3,1,0.28955251,21,18,4.918032787,2.8125,622,640,82,103
car,yolov8m,2918687630_5108e3e2ab_z.jpg,427,640,3,0,0,0,0,0,0,0,0,0,0
car,yolov8m,5333910985_ea4e62f651_z.jpg,480,640,3,0,0,0,0,0,0,0,0,0,0
car,yolov8m,211850545_7f670901ab_z.jpg,426,640,3,1,0.420762777,417,624,97.88732394,97.5,4,628,2,419
car,yolov8m,3499391979_76c0c01a3c_z.jpg,427,640,3,1,0.94787401,117,300,27.40046838,46.875,85,385,246,363
car,yolov8m,6097504753_2971a9eaa6_z.jpg,480,640,3,1,0.575394988,382,323,79.58333333,50.46875,1,324,97,479
car,yolov8m,2166320847_63a04a9303_z.jpg,427,640,3,0,0,0,0,0,0,0,0,0,0
car,yolov8m,19299023856_077e45c472_z.jpg,407,639,3,1,0.781595349,111,96,27.27272727,15.02347418,543,639,57,168
car,yolov8m,19299023856_077e45c472_z.jpg,407,639,3,1,0.610697329,271,533,66.58476658,83.41158059,46,579,70,341
car,yolov8m,3413987789_b607473327_z.jpg,480,640,3,1,0.849025905,48,76,10,11.875,564,640,128,176
car,yolov8m,3413987789_b607473327_z.jpg,480,640,3,1,0.391562074,17,12,3.541666667,1.875,0,12,126,143
car,yolov8m,13314143603_95d63b5748_z.jpg,480,640,3,1,0.857878923,80,206,16.66666667,32.1875,29,235,70,150
car,yolov8m,13314143603_95d63b5748_z.jpg,480,640,3,1,0.785610855,400,557,83.33333333,87.03125,64,621,59,459
car,yolov8m,13314143603_95d63b5748_z.jpg,480,640,3,1,0.691168785,49,40,10.20833333,6.25,600,640,75,124
car,yolov8m,13314143603_95d63b5748_z.jpg,480,640,3,1,0.680475831,49,17,10.20833333,2.65625,623,640,89,138
car,yolov8m,13314143603_95d63b5748_z.jpg,480,640,3,1,0.634283364,54,107,11.25,16.71875,233,340,72,126
car,yolov8m,7782123174_dbda292cef_z.jpg,480,640,3,1,0.900662482,121,96,25.20833333,15,544,640,216,337
car,yolov8m,15196353300_2dcb1a1948_z.jpg,426,640,3,1,0.918519378,153,162,35.91549296,25.3125,0,162,129,282
car,yolov8m,15196353300_2dcb1a1948_z.jpg,426,640,3,1,0.901011586,220,330,51.64319249,51.5625,143,473,115,335
car,yolov8m,15196353300_2dcb1a1948_z.jpg,426,640,3,1,0.887209833,24,66,5.633802817,10.3125,545,611,111,135
car,yolov8m,15196353300_2dcb1a1948_z.jpg,426,640,3,1,0.832553625,223,83,52.34741784,12.96875,557,640,115,338
car,yolov8m,15196353300_2dcb1a1948_z.jpg,426,640,3,1,0.758100986,16,17,3.755868545,2.65625,0,17,112,128
car,yolov8m,15196353300_2dcb1a1948_z.jpg,426,640,3,1,0.470739335,14,60,3.286384977,9.375,329,389,108,122
car,yolov8m,15196353300_2dcb1a1948_z.jpg,426,640,3,1,0.277142882,14,82,3.286384977,12.8125,307,389,108,122
car,yolov8n,3141821008_3743fb8be5_z.jpg,494,640,3,1,0.802316964,32,58,6.477732794,9.0625,19,77,198,230
car,yolov8n,3141821008_3743fb8be5_z.jpg,494,640,3,1,0.555271745,23,30,4.655870445,4.6875,516,546,194,217
car,yolov8n,3141821008_3743fb8be5_z.jpg,494,640,3,1,0.412484378,20,32,4.048582996,5,562,594,198,218
car,yolov8n,3141821008_3743fb8be5_z.jpg,494,640,3,1,0.379180878,12,32,2.429149798,5,105,137,198,210
car,yolov8n,3141821008_3743fb8be5_z.jpg,494,640,3,1,0.292136997,22,44,4.453441296,6.875,562,606,199,221
car,yolov8n,3141821008_3743fb8be5_z.jpg,494,640,3,1,0.262971908,20,24,4.048582996,3.75,540,564,195,215
car,yolov8n,3141821008_3743fb8be5_z.jpg,494,640,3,1,0.261758983,22,47,4.453441296,7.34375,517,564,194,216
car,yolov8n,3141821008_3743fb8be5_z.jpg,494,640,3,1,0.253362805,24,41,4.858299595,6.40625,574,615,198,222
car,yolov8n,5336089950_d2f4618519_z.jpg,384,640,3,1,0.648767829,328,420,85.41666667,65.625,174,594,13,341
car,yolov8n,2370036280_507a07c953_z.jpg,445,640,3,1,0.852719545,320,472,71.91011236,73.75,72,544,66,386
car,yolov8n,5007439610_5bb351fc1f_z.jpg,480,640,3,1,0.90802151,146,210,30.41666667,32.8125,193,403,201,347
car,yolov8n,144429519_9567ff4044_z.jpg,425,640,3,1,0.884153605,225,566,52.94117647,88.4375,46,612,177,402
car,yolov8n,5763085728_cd042a4cb0_z.jpg,428,640,3,1,0.930858254,238,541,55.60747664,84.53125,29,570,125,363
car,yolov8n,5484042252_37ce385b5f_z.jpg,480,640,3,1,0.878571272,347,501,72.29166667,78.28125,63,564,84,431
car,yolov8n,5484042252_37ce385b5f_z.jpg,480,640,3,1,0.293012589,27,31,5.625,4.84375,531,562,154,181
car,yolov8n,15490190390_d64fe16141_z.jpg,426,640,3,1,0.9377262,157,346,36.85446009,54.0625,123,469,131,288
car,yolov8n,15490190390_d64fe16141_z.jpg,426,640,3,1,0.903668284,92,244,21.59624413,38.125,30,274,65,157
car,yolov8n,10218081326_b6a2dd98f5_z.jpg,640,640,3,1,0.882272601,370,505,57.8125,78.90625,0,505,205,575
car,yolov8n,10218081326_b6a2dd98f5_z.jpg,640,640,3,1,0.682663918,122,81,19.0625,12.65625,450,531,213,335
car,yolov8n,10218081326_b6a2dd98f5_z.jpg,640,640,3,1,0.635922551,27,50,4.21875,7.8125,558,608,211,238
car,yolov8n,4597825116_8ec71a76cf_z.jpg,468,640,3,1,0.930353224,302,630,64.52991453,98.4375,7,637,111,413
car,yolov8n,4597825116_8ec71a76cf_z.jpg,468,640,3,1,0.607874215,50,26,10.68376068,4.0625,0,26,205,255
car,yolov8n,48901634_c792cbab58_z.jpg,424,640,3,1,0.902541101,231,314,54.48113208,49.0625,326,640,158,389
car,yolov8n,5516505342_43268015f4_z.jpg,480,640,3,1,0.910332561,206,465,42.91666667,72.65625,81,546,162,368
car,yolov8n,5516505342_43268015f4_z.jpg,480,640,3,1,0.848841548,120,187,25,29.21875,453,640,137,257
car,yolov8n,5516505342_43268015f4_z.jpg,480,640,3,1,0.375177741,33,80,6.875,12.5,559,639,139,172
car,yolov8n,5516505342_43268015f4_z.jpg,480,640,3,1,0.335552543,90,171,18.75,26.71875,44,215,155,245
car,yolov8n,5516505342_43268015f4_z.jpg,480,640,3,1,0.319390476,25,94,5.208333333,14.6875,284,378,154,179
car,yolov8n,5516505342_43268015f4_z.jpg,480,640,3,1,0.31239146,19,83,3.958333333,12.96875,287,370,154,173
car,yolov8n,17554656478_22dea58ed2_z.jpg,419,640,3,1,0.384908825,247,478,58.94988067,74.6875,116,594,138,385
car,yolov8n,8125475_d0a1063029_z.jpg,480,640,3,1,0.926632166,378,533,78.75,83.28125,102,635,101,479
car,yolov8n,8125475_d0a1063029_z.jpg,480,640,3,1,0.841678262,28,58,5.833333333,9.0625,532,590,118,146
car,yolov8n,8125475_d0a1063029_z.jpg,480,640,3,1,0.774745405,131,133,27.29166667,20.78125,28,161,95,226
car,yolov8n,8125475_d0a1063029_z.jpg,480,640,3,1,0.763447523,24,60,5,9.375,423,483,111,135
car,yolov8n,8125475_d0a1063029_z.jpg,480,640,3,1,0.713868916,39,55,8.125,8.59375,585,640,109,148
car,yolov8n,8125475_d0a1063029_z.jpg,480,640,3,1,0.566885233,24,42,5,6.5625,393,435,106,130
car,yolov8n,8125475_d0a1063029_z.jpg,480,640,3,1,0.558002651,28,33,5.833333333,5.15625,465,498,108,136
car,yolov8n,8125475_d0a1063029_z.jpg,480,640,3,1,0.549193025,53,43,11.04166667,6.71875,7,50,104,157
car,yolov8n,8125475_d0a1063029_z.jpg,480,640,3,1,0.405781209,50,47,10.41666667,7.34375,0,47,101,151
car,yolov8n,8125475_d0a1063029_z.jpg,480,640,3,1,0.535673797,73,39,15.20833333,6.09375,11,50,104,177
car,yolov8n,8125475_d0a1063029_z.jpg,480,640,3,1,0.301980466,34,58,7.083333333,9.0625,486,544,109,143
car,yolov8n,8125475_d0a1063029_z.jpg,480,640,3,1,0.256664723,39,47,8.125,7.34375,0,47,85,124
car,yolov8n,2433290346_8482cac895_z.jpg,425,640,3,1,0.618546247,189,554,44.47058824,86.5625,61,615,222,411
car,yolov8n,5490854064_57151abb4f_z.jpg,478,640,3,0,0,0,0,0,0,0,0,0,0
car,yolov8n,8634899263_5ce2555806_z.jpg,425,640,3,1,0.942665339,303,498,71.29411765,77.8125,119,617,95,398
car,yolov8n,750912399_32f415ecb1_z.jpg,477,640,3,1,0.771837354,54,50,11.32075472,7.8125,358,408,47,101
car,yolov8n,3595778703_d3bec2f74e_z.jpg,640,479,3,0,0,0,0,0,0,0,0,0,0
car,yolov8n,8265517869_53c5fb3eff_z.jpg,426,639,3,1,0.892526269,310,301,72.76995305,47.10485133,0,301,70,380
car,yolov8n,16982913298_aa90f2a62b_z.jpg,640,640,3,1,0.883623421,335,638,52.34375,99.6875,1,639,153,488
car,yolov8n,16982913298_aa90f2a62b_z.jpg,640,640,3,1,0.752505958,86,112,13.4375,17.5,528,640,132,218
car,yolov8n,16982913298_aa90f2a62b_z.jpg,640,640,3,1,0.714071989,59,164,9.21875,25.625,63,227,137,196
car,yolov8n,16982913298_aa90f2a62b_z.jpg,640,640,3,1,0.443825483,261,99,40.78125,15.46875,0,99,144,405
car,yolov8n,16982913298_aa90f2a62b_z.jpg,640,640,3,1,0.404733151,35,64,5.46875,10,0,64,140,175
car,yolov8n,16982913298_aa90f2a62b_z.jpg,640,640,3,1,0.305835515,98,97,15.3125,15.15625,0,97,146,244
car,yolov8n,4370423313_49f3722e85_z.jpg,480,640,3,1,0.720053852,310,592,64.58333333,92.5,29,621,112,422
car,yolov8n,8032610600_1dd81d41a4_z.jpg,427,640,3,1,0.620286644,373,312,87.35362998,48.75,1,313,15,388
car,yolov8n,82706249_bf54b24c4e_z.jpg,257,639,3,1,0.917831063,214,575,83.26848249,89.98435055,24,599,22,236
car,yolov8n,340359612_df41037e73_z.jpg,426,640,3,1,0.387562454,340,567,79.81220657,88.59375,34,601,39,379
car,yolov8n,340359612_df41037e73_z.jpg,426,640,3,1,0.329286277,93,74,21.83098592,11.5625,78,152,120,213
car,yolov8n,340359612_df41037e73_z.jpg,426,640,3,1,0.256453842,102,111,23.94366197,17.34375,0,111,159,261
car,yolov8n,432591931_4789d0f0f1_z.jpg,480,640,3,1,0.884677291,147,187,30.625,29.21875,453,640,119,266
car,yolov8n,432591931_4789d0f0f1_z.jpg,480,640,3,1,0.861901581,143,106,29.79166667,16.5625,0,106,163,306
car,yolov8n,6168484879_e6b9644722_z.jpg,427,640,3,1,0.933110476,256,551,59.95316159,86.09375,66,617,96,352
car,yolov8n,6410065163_fef2877544_z.jpg,444,640,3,1,0.457015246,341,585,76.8018018,91.40625,54,639,62,403
car,yolov8n,953262953_340a098204_z.jpg,427,640,3,1,0.836334646,223,623,52.22482436,97.34375,0,623,200,423
car,yolov8n,15038212434_9e0e575008_z.jpg,640,640,3,1,0.606084406,329,636,51.40625,99.375,4,640,211,540
car,yolov8n,15038212434_9e0e575008_z.jpg,640,640,3,1,0.308307052,165,490,25.78125,76.5625,149,639,220,385
car,yolov8n,5099996575_32762aeb7f_z.jpg,480,640,3,1,0.372768402,410,545,85.41666667,85.15625,66,611,47,457
car,yolov8n,342659307_d5d9d36af5_z.jpg,302,640,3,1,0.73950088,194,633,64.2384106,98.90625,1,634,103,297
car,yolov8n,3312304999_bc296f3260_z.jpg,369,639,3,1,0.482782751,280,616,75.88075881,96.40062598,3,619,53,333
car,yolov8n,13340204053_873cda4cef_z.jpg,359,639,3,1,0.810006201,253,554,70.4735376,86.69796557,39,593,36,289
car,yolov8n,5340010485_edeaa88c83_z.jpg,480,639,3,1,0.895940065,161,193,33.54166667,30.20344288,446,639,94,255
car,yolov8n,5340010485_edeaa88c83_z.jpg,480,639,3,1,0.889046967,263,488,54.79166667,76.36932707,33,521,119,382
car,yolov8n,5340010485_edeaa88c83_z.jpg,480,639,3,1,0.276274025,49,27,10.20833333,4.225352113,0,27,98,147
car,yolov8n,2525539133_73f08a9471_z.jpg,427,640,3,1,0.928555667,174,445,40.74941452,69.53125,154,599,183,357
car,yolov8n,6431153899_9ac59a36b4_z.jpg,480,640,3,1,0.565013707,256,561,53.33333333,87.65625,50,611,193,449
car,yolov8n,6431153899_9ac59a36b4_z.jpg,480,640,3,1,0.524915457,437,585,91.04166667,91.40625,38,623,13,450
car,yolov8n,16106543870_2f167db1e1_z.jpg,480,640,3,0,0,0,0,0,0,0,0,0,0
car,yolov8n,19577109682_a0282d8678_z.jpg,458,640,3,0,0,0,0,0,0,0,0,0,0
car,yolov8n,6010263871_df93fb6382_z.jpg,427,640,3,1,0.851106942,111,272,25.99531616,42.5,307,579,98,209
car,yolov8n,6010263871_df93fb6382_z.jpg,427,640,3,1,0.837275326,137,159,32.08430913,24.84375,481,640,143,280
car,yolov8n,6010263871_df93fb6382_z.jpg,427,640,3,1,0.823788524,157,330,36.76814988,51.5625,0,330,136,293
car,yolov8n,6010263871_df93fb6382_z.jpg,427,640,3,1,0.423459232,18,50,4.215456674,7.8125,193,243,1,19
car,yolov8n,6010263871_df93fb6382_z.jpg,427,640,3,1,0.315470397,17,67,3.981264637,10.46875,401,468,0,17
car,yolov8n,6010263871_df93fb6382_z.jpg,427,640,3,1,0.254912287,20,47,4.683840749,7.34375,74,121,0,20
car,yolov8n,7110476047_267467ee68_z.jpg,450,640,3,1,0.838149071,72,110,16,17.1875,20,130,175,247
car,yolov8n,7110476047_267467ee68_z.jpg,450,640,3,1,0.820576966,95,98,21.11111111,15.3125,532,630,164,259
car,yolov8n,7110476047_267467ee68_z.jpg,450,640,3,1,0.796953499,311,473,69.11111111,73.90625,89,562,88,399
car,yolov8n,7110476047_267467ee68_z.jpg,450,640,3,1,0.596955657,66,70,14.66666667,10.9375,570,640,155,221
car,yolov8n,7035751851_15d745cf2c_z.jpg,480,640,3,1,0.953131974,160,278,33.33333333,43.4375,0,278,99,259
car,yolov8n,7035751851_15d745cf2c_z.jpg,480,640,3,1,0.881210148,264,579,55,90.46875,53,632,107,371
car,yolov8n,7035751851_15d745cf2c_z.jpg,480,640,3,1,0.380565882,53,94,11.04166667,14.6875,0,94,101,154
car,yolov8n,7035751851_15d745cf2c_z.jpg,480,640,3,1,0.25622052,17,31,3.541666667,4.84375,314,345,72,89
car,yolov8n,3157735385_c9e7580f03_z.jpg,471,640,3,0,0,0,0,0,0,0,0,0,0
car,yolov8n,3679100484_a8e3044e55_z.jpg,480,640,3,1,0.791154742,176,590,36.66666667,92.1875,19,609,149,325
car,yolov8n,9238365388_d2bb1bb2e4_z.jpg,424,640,3,1,0.57201165,368,581,86.79245283,90.78125,0,581,4,372
car,yolov8n,14786765330_5d381d2451_z.jpg,480,640,3,1,0.929131925,320,570,66.66666667,89.0625,25,595,98,418
car,yolov8n,14786765330_5d381d2451_z.jpg,480,640,3,1,0.50225544,26,39,5.416666667,6.09375,249,288,129,155
car,yolov8n,14786765330_5d381d2451_z.jpg,480,640,3,1,0.484487355,64,77,13.33333333,12.03125,563,640,132,196
car,yolov8n,14786765330_5d381d2451_z.jpg,480,640,3,1,0.278391182,42,16,8.75,2.5,624,640,176,218
car,yolov8n,20795376805_7d3aabfce1_z.jpg,400,640,3,1,0.843737066,193,400,48.25,62.5,92,492,135,328
car,yolov8n,9057859369_5a432fdfe1_z.jpg,427,640,3,1,0.892080903,311,518,72.83372365,80.9375,55,573,69,380
car,yolov8n,9057859369_5a432fdfe1_z.jpg,427,640,3,1,0.7575683,153,172,35.83138173,26.875,468,640,24,177
car,yolov8n,9549882142_c59c04bac0_z.jpg,379,600,3,1,0.876276195,256,243,67.54617414,40.5,0,243,93,349
car,yolov8n,9549882142_c59c04bac0_z.jpg,379,600,3,1,0.844818056,184,167,48.54881266,27.83333333,125,292,105,289
car,yolov8n,9549882142_c59c04bac0_z.jpg,379,600,3,1,0.813984156,235,190,62.00527704,31.66666667,410,600,79,314
car,yolov8n,9549882142_c59c04bac0_z.jpg,379,600,3,1,0.612641394,193,97,50.92348285,16.16666667,364,461,96,289
car,yolov8n,5575004957_c281c5de1f_z.jpg,480,640,3,1,0.80560863,148,137,30.83333333,21.40625,503,640,119,267
car,yolov8n,5575004957_c281c5de1f_z.jpg,480,640,3,1,0.586049855,317,536,66.04166667,83.75,54,590,111,428
car,yolov8n,2468082692_49ec682990_z.jpg,480,640,3,0,0,0,0,0,0,0,0,0,0
car,yolov8n,5466970559_0f7b06bcd6_z.jpg,427,640,3,1,0.820121825,381,606,89.22716628,94.6875,25,631,26,407
car,yolov8n,5466970559_0f7b06bcd6_z.jpg,427,640,3,1,0.517961919,33,63,7.728337237,9.84375,574,637,86,119
car,yolov8n,5466970559_0f7b06bcd6_z.jpg,427,640,3,1,0.426517963,125,64,29.27400468,10,576,640,96,221
car,yolov8n,5466970559_0f7b06bcd6_z.jpg,427,640,3,1,0.32881996,76,109,17.79859485,17.03125,9,118,0,76
car,yolov8n,2918687630_5108e3e2ab_z.jpg,427,640,3,0,0,0,0,0,0,0,0,0,0
car,yolov8n,5333910985_ea4e62f651_z.jpg,480,640,3,1,0.521977425,461,638,96.04166667,99.6875,1,639,18,479
car,yolov8n,211850545_7f670901ab_z.jpg,426,640,3,1,0.389316916,96,235,22.53521127,36.71875,299,534,326,422
car,yolov8n,3499391979_76c0c01a3c_z.jpg,427,640,3,1,0.934803605,117,300,27.40046838,46.875,85,385,246,363
car,yolov8n,6097504753_2971a9eaa6_z.jpg,480,640,3,1,0.435817927,140,344,29.16666667,53.75,241,585,34,174
car,yolov8n,6097504753_2971a9eaa6_z.jpg,480,640,3,1,0.33088094,243,414,50.625,64.6875,76,490,59,302
car,yolov8n,6097504753_2971a9eaa6_z.jpg,480,640,3,1,0.327606022,151,389,31.45833333,60.78125,73,462,58,209
car,yolov8n,2166320847_63a04a9303_z.jpg,427,640,3,0,0,0,0,0,0,0,0,0,0
car,yolov8n,19299023856_077e45c472_z.jpg,407,639,3,1,0.690291047,270,548,66.33906634,85.75899844,44,592,70,340
car,yolov8n,19299023856_077e45c472_z.jpg,407,639,3,1,0.527704,113,96,27.76412776,15.02347418,543,639,57,170
car,yolov8n,3413987789_b607473327_z.jpg,480,640,3,1,0.717732728,48,76,10,11.875,564,640,128,176
car,yolov8n,3413987789_b607473327_z.jpg,480,640,3,1,0.300241292,18,14,3.75,2.1875,0,14,125,143
car,yolov8n,13314143603_95d63b5748_z.jpg,480,640,3,1,0.701610863,50,18,10.41666667,2.8125,622,640,92,142
car,yolov8n,13314143603_95d63b5748_z.jpg,480,640,3,1,0.690722048,82,216,17.08333333,33.75,28,244,69,151
car,yolov8n,13314143603_95d63b5748_z.jpg,480,640,3,1,0.579379082,45,40,9.375,6.25,600,640,79,124
car,yolov8n,13314143603_95d63b5748_z.jpg,480,640,3,1,0.454634756,400,565,83.33333333,88.28125,67,632,56,456
car,yolov8n,7782123174_dbda292cef_z.jpg,480,640,3,1,0.869591355,124,95,25.83333333,14.84375,545,640,217,341
car,yolov8n,15196353300_2dcb1a1948_z.jpg,426,640,3,1,0.898750365,224,330,52.58215962,51.5625,142,472,110,334
car,yolov8n,15196353300_2dcb1a1948_z.jpg,426,640,3,1,0.78894639,24,67,5.633802817,10.46875,544,611,111,135
car,yolov8n,15196353300_2dcb1a1948_z.jpg,426,640,3,1,0.712168097,154,162,36.15023474,25.3125,0,162,128,282
car,yolov8n,15196353300_2dcb1a1948_z.jpg,426,640,3,1,0.601459384,221,83,51.87793427,12.96875,557,640,113,334
car,yolov8n,15196353300_2dcb1a1948_z.jpg,426,640,3,1,0.425412387,17,17,3.990610329,2.65625,0,17,112,129
car,yolov8n,15196353300_2dcb1a1948_z.jpg,426,640,3,1,0.264836043,16,30,3.755868545,4.6875,36,66,112,128
car,yolov8s,3141821008_3743fb8be5_z.jpg,494,640,3,1,0.884282887,32,59,6.477732794,9.21875,18,77,198,230
car,yolov8s,3141821008_3743fb8be5_z.jpg,494,640,3,1,0.682151973,24,48,4.858299595,7.5,516,564,192,216
car,yolov8s,3141821008_3743fb8be5_z.jpg,494,640,3,1,0.417639732,17,29,3.441295547,4.53125,564,593,198,215
car,yolov8s,3141821008_3743fb8be5_z.jpg,494,640,3,1,0.385445654,18,43,3.643724696,6.71875,562,605,198,216
car,yolov8s,3141821008_3743fb8be5_z.jpg,494,640,3,1,0.361595809,21,39,4.251012146,6.09375,578,617,199,220
car,yolov8s,3141821008_3743fb8be5_z.jpg,494,640,3,1,0.326268196,12,32,2.429149798,5,105,137,198,210
car,yolov8s,5336089950_d2f4618519_z.jpg,384,640,3,1,0.882917881,333,407,86.71875,63.59375,190,597,10,343
car,yolov8s,2370036280_507a07c953_z.jpg,445,640,3,1,0.887260318,316,465,71.01123596,72.65625,79,544,65,381
car,yolov8s,5007439610_5bb351fc1f_z.jpg,480,640,3,1,0.922166646,144,207,30,32.34375,196,403,202,346
car,yolov8s,144429519_9567ff4044_z.jpg,425,640,3,1,0.923490584,227,555,53.41176471,86.71875,47,602,176,403
car,yolov8s,5763085728_cd042a4cb0_z.jpg,428,640,3,1,0.945637226,239,542,55.8411215,84.6875,31,573,125,364
car,yolov8s,5484042252_37ce385b5f_z.jpg,480,640,3,1,0.885298252,345,502,71.875,78.4375,62,564,82,427
car,yolov8s,15490190390_d64fe16141_z.jpg,426,640,3,1,0.934568465,157,350,36.85446009,54.6875,122,472,131,288
car,yolov8s,15490190390_d64fe16141_z.jpg,426,640,3,1,0.920573175,92,243,21.59624413,37.96875,31,274,64,156
car,yolov8s,10218081326_b6a2dd98f5_z.jpg,640,640,3,1,0.927168608,367,510,57.34375,79.6875,0,510,207,574
car,yolov8s,10218081326_b6a2dd98f5_z.jpg,640,640,3,1,0.851575494,136,83,21.25,12.96875,449,532,213,349
car,yolov8s,10218081326_b6a2dd98f5_z.jpg,640,640,3,1,0.603822231,27,49,4.21875,7.65625,558,607,211,238
car,yolov8s,10218081326_b6a2dd98f5_z.jpg,640,640,3,1,0.590626895,29,81,4.53125,12.65625,558,639,210,239
car,yolov8s,10218081326_b6a2dd98f5_z.jpg,640,640,3,1,0.355863243,39,83,6.09375,12.96875,153,236,210,249
car,yolov8s,4597825116_8ec71a76cf_z.jpg,468,640,3,1,0.930247962,303,626,64.74358974,97.8125,12,638,110,413
car,yolov8s,4597825116_8ec71a76cf_z.jpg,468,640,3,1,0.564388156,48,26,10.25641026,4.0625,0,26,208,256
car,yolov8s,4597825116_8ec71a76cf_z.jpg,468,640,3,1,0.349337339,49,35,10.47008547,5.46875,0,35,206,255
car,yolov8s,4597825116_8ec71a76cf_z.jpg,468,640,3,1,0.284444779,46,62,9.829059829,9.6875,11,73,201,247
car,yolov8s,4597825116_8ec71a76cf_z.jpg,468,640,3,1,0.277875632,70,19,14.95726496,2.96875,621,640,203,273
car,yolov8s,48901634_c792cbab58_z.jpg,424,640,3,1,0.670386314,227,311,53.53773585,48.59375,328,639,157,384
car,yolov8s,5516505342_43268015f4_z.jpg,480,640,3,1,0.927432239,206,465,42.91666667,72.65625,81,546,161,367
car,yolov8s,5516505342_43268015f4_z.jpg,480,640,3,1,0.856691122,121,193,25.20833333,30.15625,447,640,136,257
car,yolov8s,5516505342_43268015f4_z.jpg,480,640,3,1,0.688715577,35,81,7.291666667,12.65625,559,640,138,173
car,yolov8s,5516505342_43268015f4_z.jpg,480,640,3,1,0.295365751,24,92,5,14.375,288,380,154,178
car,yolov8s,5516505342_43268015f4_z.jpg,480,640,3,1,0.295304447,19,24,3.958333333,3.75,616,640,138,157
car,yolov8s,17554656478_22dea58ed2_z.jpg,419,640,3,1,0.758346558,248,475,59.18854415,74.21875,118,593,138,386
car,yolov8s,8125475_d0a1063029_z.jpg,480,640,3,1,0.935308278,377,538,78.54166667,84.0625,100,638,102,479
car,yolov8s,8125475_d0a1063029_z.jpg,480,640,3,1,0.786645651,29,61,6.041666667,9.53125,530,591,118,147
car,yolov8s,8125475_d0a1063029_z.jpg,480,640,3,1,0.762377024,24,67,5,10.46875,420,487,111,135
car,yolov8s,8125475_d0a1063029_z.jpg,480,640,3,1,0.739761829,68,37,14.16666667,5.78125,12,49,104,172
car,yolov8s,8125475_d0a1063029_z.jpg,480,640,3,1,0.696725547,40,55,8.333333333,8.59375,585,640,109,149
car,yolov8s,8125475_d0a1063029_z.jpg,480,640,3,1,0.685148418,132,135,27.5,21.09375,25,160,95,227
car,yolov8s,8125475_d0a1063029_z.jpg,480,640,3,1,0.582228243,23,43,4.791666667,6.71875,392,435,106,129
car,yolov8s,8125475_d0a1063029_z.jpg,480,640,3,1,0.554734111,29,32,6.041666667,5,465,497,107,136
car,yolov8s,8125475_d0a1063029_z.jpg,480,640,3,1,0.498546422,48,49,10,7.65625,0,49,102,150
car,yolov8s,8125475_d0a1063029_z.jpg,480,640,3,1,0.359228641,34,48,7.083333333,7.5,0,48,85,119
car,yolov8s,2433290346_8482cac895_z.jpg,425,640,3,1,0.928097665,188,494,44.23529412,77.1875,54,548,221,409
car,yolov8s,5490854064_57151abb4f_z.jpg,478,640,3,0,0,0,0,0,0,0,0,0,0
car,yolov8s,8634899263_5ce2555806_z.jpg,425,640,3,1,0.926401258,292,498,68.70588235,77.8125,121,619,95,387
car,yolov8s,750912399_32f415ecb1_z.jpg,477,640,3,1,0.826257825,54,51,11.32075472,7.96875,358,409,46,100
car,yolov8s,3595778703_d3bec2f74e_z.jpg,640,479,3,0,0,0,0,0,0,0,0,0,0
car,yolov8s,8265517869_53c5fb3eff_z.jpg,426,639,3,1,0.929070055,308,296,72.30046948,46.32237872,1,297,69,377
car,yolov8s,8265517869_53c5fb3eff_z.jpg,426,639,3,1,0.34169811,127,58,29.81220657,9.076682316,241,299,118,245
car,yolov8s,16982913298_aa90f2a62b_z.jpg,640,640,3,1,0.879848182,93,97,14.53125,15.15625,0,97,147,240
car,yolov8s,16982913298_aa90f2a62b_z.jpg,640,640,3,1,0.864204109,343,638,53.59375,99.6875,1,639,150,493
car,yolov8s,16982913298_aa90f2a62b_z.jpg,640,640,3,1,0.836972237,87,112,13.59375,17.5,528,640,132,219
car,yolov8s,16982913298_aa90f2a62b_z.jpg,640,640,3,1,0.722183287,60,159,9.375,24.84375,66,225,137,197
car,yolov8s,16982913298_aa90f2a62b_z.jpg,640,640,3,1,0.577418864,37,66,5.78125,10.3125,0,66,139,176
car,yolov8s,16982913298_aa90f2a62b_z.jpg,640,640,3,1,0.437098175,41,85,6.40625,13.28125,1,86,140,181
car,yolov8s,4370423313_49f3722e85_z.jpg,480,640,3,1,0.91322279,310,576,64.58333333,90,50,626,113,423
car,yolov8s,8032610600_1dd81d41a4_z.jpg,427,640,3,1,0.898989141,338,311,79.15690867,48.59375,1,312,52,390
car,yolov8s,82706249_bf54b24c4e_z.jpg,257,639,3,1,0.917471886,212,566,82.49027237,88.57589984,24,590,22,234
car,yolov8s,340359612_df41037e73_z.jpg,426,640,3,1,0.804929197,95,108,22.30046948,16.875,0,108,163,258
car,yolov8s,340359612_df41037e73_z.jpg,426,640,3,1,0.595760047,98,75,23.00469484,11.71875,77,152,119,217
car,yolov8s,432591931_4789d0f0f1_z.jpg,480,640,3,1,0.924276829,148,187,30.83333333,29.21875,453,640,119,267
car,yolov8s,432591931_4789d0f0f1_z.jpg,480,640,3,1,0.86960417,140,104,29.16666667,16.25,0,104,165,305
car,yolov8s,6168484879_e6b9644722_z.jpg,427,640,3,1,0.931487024,258,536,60.42154567,83.75,71,607,94,352
car,yolov8s,6410065163_fef2877544_z.jpg,444,640,3,1,0.669641435,342,598,77.02702703,93.4375,41,639,62,404
car,yolov8s,953262953_340a098204_z.jpg,427,640,3,1,0.922808588,223,619,52.22482436,96.71875,0,619,200,423
car,yolov8s,15038212434_9e0e575008_z.jpg,640,640,3,1,0.594588757,186,492,29.0625,76.875,148,640,221,407
car,yolov8s,15038212434_9e0e575008_z.jpg,640,640,3,1,0.490726262,301,495,47.03125,77.34375,144,639,221,522
car,yolov8s,5099996575_32762aeb7f_z.jpg,480,640,3,1,0.671333015,405,546,84.375,85.3125,65,611,46,451
car,yolov8s,342659307_d5d9d36af5_z.jpg,302,640,3,1,0.911828637,194,638,64.2384106,99.6875,2,640,108,302
car,yolov8s,3312304999_bc296f3260_z.jpg,369,639,3,1,0.735898018,276,613,74.79674797,95.93114241,2,615,55,331
car,yolov8s,13340204053_873cda4cef_z.jpg,359,639,3,1,0.886193573,255,552,71.03064067,86.38497653,40,592,33,288
car,yolov8s,5340010485_edeaa88c83_z.jpg,480,639,3,1,0.916936576,160,193,33.33333333,30.20344288,446,639,94,254
car,yolov8s,5340010485_edeaa88c83_z.jpg,480,639,3,1,0.89403832,260,476,54.16666667,74.4913928,37,513,120,380
car,yolov8s,5340010485_edeaa88c83_z.jpg,480,639,3,1,0.628037453,47,27,9.791666667,4.225352113,0,27,98,145
car,yolov8s,2525539133_73f08a9471_z.jpg,427,640,3,1,0.935783148,173,444,40.51522248,69.375,154,598,184,357
car,yolov8s,6431153899_9ac59a36b4_z.jpg,480,640,3,1,0.837662101,250,554,52.08333333,86.5625,54,608,195,445
car,yolov8s,16106543870_2f167db1e1_z.jpg,480,640,3,1,0.611953855,277,623,57.70833333,97.34375,10,633,106,383
car,yolov8s,19577109682_a0282d8678_z.jpg,458,640,3,1,0.919745803,262,597,57.20524017,93.28125,13,610,108,370
car,yolov8s,6010263871_df93fb6382_z.jpg,427,640,3,1,0.936090589,156,329,36.53395785,51.40625,0,329,135,291
car,yolov8s,6010263871_df93fb6382_z.jpg,427,640,3,1,0.864728928,110,273,25.76112412,42.65625,306,579,99,209
car,yolov8s,6010263871_df93fb6382_z.jpg,427,640,3,1,0.704065621,76,165,17.79859485,25.78125,9,174,122,198
car,yolov8s,6010263871_df93fb6382_z.jpg,427,640,3,1,0.559175432,138,160,32.31850117,25,480,640,142,280
car,yolov8s,6010263871_df93fb6382_z.jpg,427,640,3,1,0.359219462,13,36,3.044496487,5.625,367,403,0,13
car,yolov8s,6010263871_df93fb6382_z.jpg,427,640,3,1,0.351947129,16,31,3.7470726,4.84375,146,177,1,17
car,yolov8s,6010263871_df93fb6382_z.jpg,427,640,3,1,0.292952955,18,52,4.215456674,8.125,192,244,0,18
car,yolov8s,7110476047_267467ee68_z.jpg,450,640,3,1,0.883213401,72,107,16,16.71875,21,128,176,248
car,yolov8s,7110476047_267467ee68_z.jpg,450,640,3,1,0.839358866,90,98,20,15.3125,534,632,164,254
car,yolov8s,7110476047_267467ee68_z.jpg,450,640,3,1,0.809016764,66,74,14.66666667,11.5625,565,639,155,221
car,yolov8s,7110476047_267467ee68_z.jpg,450,640,3,1,0.763196111,312,471,69.33333333,73.59375,93,564,88,400
car,yolov8s,7035751851_15d745cf2c_z.jpg,480,640,3,1,0.922972202,159,278,33.125,43.4375,0,278,100,259
car,yolov8s,7035751851_15d745cf2c_z.jpg,480,640,3,1,0.909964144,267,563,55.625,87.96875,54,617,107,374
car,yolov8s,7035751851_15d745cf2c_z.jpg,480,640,3,1,0.53506583,53,96,11.04166667,15,0,96,101,154
car,yolov8s,7035751851_15d745cf2c_z.jpg,480,640,3,1,0.255715102,17,28,3.541666667,4.375,317,345,72,89
car,yolov8s,3157735385_c9e7580f03_z.jpg,471,640,3,1,0.90632993,219,635,46.49681529,99.21875,1,636,228,447
car,yolov8s,3679100484_a8e3044e55_z.jpg,480,640,3,1,0.905118942,181,593,37.70833333,92.65625,22,615,149,330
car,yolov8s,9238365388_d2bb1bb2e4_z.jpg,424,640,3,1,0.908499777,362,579,85.37735849,90.46875,1,580,10,372
car,yolov8s,9238365388_d2bb1bb2e4_z.jpg,424,640,3,1,0.449199438,69,109,16.27358491,17.03125,531,640,58,127
car,yolov8s,9238365388_d2bb1bb2e4_z.jpg,424,640,3,1,0.407954156,224,628,52.83018868,98.125,11,639,38,262
car,yolov8s,14786765330_5d381d2451_z.jpg,480,640,3,1,0.906175017,317,578,66.04166667,90.3125,21,599,101,418
car,yolov8s,14786765330_5d381d2451_z.jpg,480,640,3,1,0.422950268,64,76,13.33333333,11.875,564,640,131,195
car,yolov8s,14786765330_5d381d2451_z.jpg,480,640,3,1,0.473551452,26,40,5.416666667,6.25,249,289,129,155
car,yolov8s,14786765330_5d381d2451_z.jpg,480,640,3,1,0.285108626,26,56,5.416666667,8.75,232,288,129,155
car,yolov8s,20795376805_7d3aabfce1_z.jpg,400,640,3,1,0.919085681,192,391,48,61.09375,102,493,135,327
car,yolov8s,9057859369_5a432fdfe1_z.jpg,427,640,3,1,0.938821256,311,517,72.83372365,80.78125,52,569,68,379
car,yolov8s,9057859369_5a432fdfe1_z.jpg,427,640,3,1,0.888542593,151,171,35.36299766,26.71875,469,640,25,176
car,yolov8s,9549882142_c59c04bac0_z.jpg,379,600,3,1,0.948950887,255,243,67.2823219,40.5,0,243,93,348
car,yolov8s,9549882142_c59c04bac0_z.jpg,379,600,3,1,0.939831495,196,92,51.71503958,15.33333333,369,461,94,290
car,yolov8s,9549882142_c59c04bac0_z.jpg,379,600,3,1,0.915595472,237,181,62.53298153,30.16666667,419,600,78,315
car,yolov8s,9549882142_c59c04bac0_z.jpg,379,600,3,1,0.910102844,198,172,52.24274406,28.66666667,121,293,91,289
car,yolov8s,5575004957_c281c5de1f_z.jpg,480,640,3,1,0.855451584,319,538,66.45833333,84.0625,56,594,110,429
car,yolov8s,5575004957_c281c5de1f_z.jpg,480,640,3,1,0.626246691,150,138,31.25,21.5625,502,640,119,269
car,yolov8s,2468082692_49ec682990_z.jpg,480,640,3,0,0,0,0,0,0,0,0,0,0
car,yolov8s,5466970559_0f7b06bcd6_z.jpg,427,640,3,1,0.943104208,379,595,88.7587822,92.96875,28,623,25,404
car,yolov8s,5466970559_0f7b06bcd6_z.jpg,427,640,3,1,0.837518156,119,58,27.86885246,9.0625,582,640,100,219
car,yolov8s,5466970559_0f7b06bcd6_z.jpg,427,640,3,1,0.534263909,33,66,7.728337237,10.3125,570,636,86,119
car,yolov8s,5466970559_0f7b06bcd6_z.jpg,427,640,3,1,0.314969718,18,21,4.215456674,3.28125,619,640,83,101
car,yolov8s,5466970559_0f7b06bcd6_z.jpg,427,640,3,1,0.310310632,40,47,9.367681499,7.34375,560,607,96,136
car,yolov8s,5466970559_0f7b06bcd6_z.jpg,427,640,3,1,0.258213192,76,97,17.79859485,15.15625,21,118,0,76
car,yolov8s,2918687630_5108e3e2ab_z.jpg,427,640,3,0,0,0,0,0,0,0,0,0,0
car,yolov8s,5333910985_ea4e62f651_z.jpg,480,640,3,1,0.458738416,461,633,96.04166667,98.90625,2,635,17,478
car,yolov8s,211850545_7f670901ab_z.jpg,426,640,3,1,0.365985155,419,632,98.35680751,98.75,3,635,0,419
car,yolov8s,3499391979_76c0c01a3c_z.jpg,427,640,3,1,0.947001696,116,299,27.16627635,46.71875,85,384,246,362
car,yolov8s,6097504753_2971a9eaa6_z.jpg,480,640,3,1,0.433152497,150,393,31.25,61.40625,232,625,34,184
car,yolov8s,2166320847_63a04a9303_z.jpg,427,640,3,0,0,0,0,0,0,0,0,0,0
car,yolov8s,19299023856_077e45c472_z.jpg,407,639,3,1,0.567573607,113,96,27.76412776,15.02347418,543,639,57,170
car,yolov8s,3413987789_b607473327_z.jpg,480,640,3,1,0.835778594,49,77,10.20833333,12.03125,563,640,128,177
car,yolov8s,3413987789_b607473327_z.jpg,480,640,3,1,0.478388757,401,598,83.54166667,93.4375,16,614,74,475
car,yolov8s,3413987789_b607473327_z.jpg,480,640,3,1,0.437302887,17,11,3.541666667,1.71875,0,11,125,142
car,yolov8s,13314143603_95d63b5748_z.jpg,480,640,3,1,0.899429262,390,554,81.25,86.5625,67,621,62,452
car,yolov8s,13314143603_95d63b5748_z.jpg,480,640,3,1,0.836208582,81,202,16.875,31.5625,33,235,70,151
car,yolov8s,13314143603_95d63b5748_z.jpg,480,640,3,1,0.672104061,45,41,9.375,6.40625,599,640,77,122
car,yolov8s,13314143603_95d63b5748_z.jpg,480,640,3,1,0.611824036,45,16,9.375,2.5,624,640,91,136
car,yolov8s,13314143603_95d63b5748_z.jpg,480,640,3,1,0.415854722,55,108,11.45833333,16.875,231,339,72,127
car,yolov8s,7782123174_dbda292cef_z.jpg,480,640,3,1,0.890387356,121,96,25.20833333,15,544,640,217,338
car,yolov8s,7782123174_dbda292cef_z.jpg,480,640,3,1,0.773357868,345,553,71.875,86.40625,23,576,135,480
car,yolov8s,15196353300_2dcb1a1948_z.jpg,426,640,3,1,0.892913759,154,162,36.15023474,25.3125,0,162,128,282
car,yolov8s,15196353300_2dcb1a1948_z.jpg,426,640,3,1,0.890745282,220,329,51.64319249,51.40625,143,472,115,335
car,yolov8s,15196353300_2dcb1a1948_z.jpg,426,640,3,1,0.848378062,23,66,5.399061033,10.3125,544,610,111,134
car,yolov8s,15196353300_2dcb1a1948_z.jpg,426,640,3,1,0.611264586,217,82,50.93896714,12.8125,558,640,113,330
car,yolov8s,15196353300_2dcb1a1948_z.jpg,426,640,3,1,0.517864048,16,18,3.755868545,2.8125,0,18,112,128
car,yolov8s,15196353300_2dcb1a1948_z.jpg,426,640,3,1,0.256888866,11,61,2.582159624,9.53125,328,389,108,119
car,yolov8x,3141821008_3743fb8be5_z.jpg,494,640,3,1,0.890302837,32,61,6.477732794,9.53125,18,79,198,230
car,yolov8x,3141821008_3743fb8be5_z.jpg,494,640,3,1,0.756845593,21,39,4.251012146,6.09375,578,617,199,220
car,yolov8x,3141821008_3743fb8be5_z.jpg,494,640,3,1,0.709656894,15,28,3.036437247,4.375,563,591,199,214
car,yolov8x,3141821008_3743fb8be5_z.jpg,494,640,3,1,0.679737091,263,483,53.2388664,75.46875,75,558,186,449
car,yolov8x,3141821008_3743fb8be5_z.jpg,494,640,3,1,0.392211944,12,36,2.429149798,5.625,105,141,198,210
car,yolov8x,5336089950_d2f4618519_z.jpg,384,640,3,1,0.97507304,335,404,87.23958333,63.125,190,594,11,346
car,yolov8x,2370036280_507a07c953_z.jpg,445,640,3,1,0.967292368,321,461,72.13483146,72.03125,80,541,65,386
car,yolov8x,5007439610_5bb351fc1f_z.jpg,480,640,3,1,0.937083662,144,208,30,32.5,195,403,203,347
car,yolov8x,144429519_9567ff4044_z.jpg,425,640,3,1,0.971820414,226,564,53.17647059,88.125,44,608,177,403
car,yolov8x,5763085728_cd042a4cb0_z.jpg,428,640,3,1,0.970196128,239,542,55.8411215,84.6875,30,572,125,364
car,yolov8x,5484042252_37ce385b5f_z.jpg,480,640,3,1,0.971103907,344,511,71.66666667,79.84375,53,564,83,427
car,yolov8x,15490190390_d64fe16141_z.jpg,426,640,3,1,0.947794199,157,352,36.85446009,55,121,473,131,288
car,yolov8x,15490190390_d64fe16141_z.jpg,426,640,3,1,0.914689958,92,244,21.59624413,38.125,31,275,65,157
car,yolov8x,10218081326_b6a2dd98f5_z.jpg,640,640,3,1,0.976214468,363,506,56.71875,79.0625,0,506,207,570
car,yolov8x,10218081326_b6a2dd98f5_z.jpg,640,640,3,1,0.891276956,150,85,23.4375,13.28125,448,533,213,363
car,yolov8x,10218081326_b6a2dd98f5_z.jpg,640,640,3,1,0.840572715,29,81,4.53125,12.65625,558,639,211,240
car,yolov8x,10218081326_b6a2dd98f5_z.jpg,640,640,3,1,0.481002122,47,60,7.34375,9.375,104,164,238,285
car,yolov8x,4597825116_8ec71a76cf_z.jpg,468,640,3,1,0.964648664,304,625,64.95726496,97.65625,12,637,111,415
car,yolov8x,4597825116_8ec71a76cf_z.jpg,468,640,3,1,0.847776771,53,71,11.32478632,11.09375,0,71,202,255
car,yolov8x,48901634_c792cbab58_z.jpg,424,640,3,1,0.941163182,227,310,53.53773585,48.4375,329,639,158,385
car,yolov8x,5516505342_43268015f4_z.jpg,480,640,3,1,0.957858622,204,466,42.5,72.8125,81,547,164,368
car,yolov8x,5516505342_43268015f4_z.jpg,480,640,3,1,0.948183835,120,186,25,29.0625,454,640,137,257
car,yolov8x,5516505342_43268015f4_z.jpg,480,640,3,1,0.86288178,35,82,7.291666667,12.8125,558,640,138,173
car,yolov8x,5516505342_43268015f4_z.jpg,480,640,3,1,0.758688331,21,91,4.375,14.21875,289,380,155,176
car,yolov8x,5516505342_43268015f4_z.jpg,480,640,3,1,0.465129346,15,24,3.125,3.75,616,640,138,153
car,yolov8x,5516505342_43268015f4_z.jpg,480,640,3,1,0.354997188,46,77,9.583333333,12.03125,0,77,177,223
car,yolov8x,17554656478_22dea58ed2_z.jpg,419,640,3,1,0.84963727,250,482,59.66587112,75.3125,114,596,137,387
car,yolov8x,8125475_d0a1063029_z.jpg,480,640,3,1,0.960088491,376,537,78.33333333,83.90625,99,636,103,479
car,yolov8x,8125475_d0a1063029_z.jpg,480,640,3,1,0.914124131,131,136,27.29166667,21.25,24,160,95,226
car,yolov8x,8125475_d0a1063029_z.jpg,480,640,3,1,0.866491318,30,63,6.25,9.84375,529,592,117,147
car,yolov8x,8125475_d0a1063029_z.jpg,480,640,3,1,0.842753112,51,48,10.625,7.5,0,48,101,152
car,yolov8x,8125475_d0a1063029_z.jpg,480,640,3,1,0.836243033,63,37,13.125,5.78125,12,49,105,168
car,yolov8x,8125475_d0a1063029_z.jpg,480,640,3,1,0.800423443,41,58,8.541666667,9.0625,582,640,108,149
car,yolov8x,8125475_d0a1063029_z.jpg,480,640,3,1,0.667351246,23,37,4.791666667,5.78125,397,434,107,130
car,yolov8x,8125475_d0a1063029_z.jpg,480,640,3,1,0.637998581,27,48,5.625,7.5,0,48,85,112
car,yolov8x,8125475_d0a1063029_z.jpg,480,640,3,1,0.594616473,21,53,4.375,8.28125,419,472,111,132
car,yolov8x,8125475_d0a1063029_z.jpg,480,640,3,1,0.574033737,28,30,5.833333333,4.6875,467,497,108,136
car,yolov8x,8125475_d0a1063029_z.jpg,480,640,3,1,0.32256797,11,62,2.291666667,9.6875,91,153,88,99
car,yolov8x,8125475_d0a1063029_z.jpg,480,640,3,1,0.319502383,29,50,6.041666667,7.8125,447,497,108,137
car,yolov8x,2433290346_8482cac895_z.jpg,425,640,3,1,0.96219486,192,495,45.17647059,77.34375,57,552,221,413
car,yolov8x,5490854064_57151abb4f_z.jpg,478,640,3,0,0,0,0,0,0,0,0,0,0
car,yolov8x,8634899263_5ce2555806_z.jpg,425,640,3,1,0.97206974,306,489,72,76.40625,124,613,95,401
car,yolov8x,750912399_32f415ecb1_z.jpg,477,640,3,1,0.777704537,53,48,11.11111111,7.5,358,406,46,99
car,yolov8x,3595778703_d3bec2f74e_z.jpg,640,479,3,0,0,0,0,0,0,0,0,0,0
car,yolov8x,8265517869_53c5fb3eff_z.jpg,426,639,3,1,0.952844024,305,296,71.59624413,46.32237872,1,297,70,375
car,yolov8x,8265517869_53c5fb3eff_z.jpg,426,639,3,1,0.26281321,130,57,30.51643192,8.920187793,242,299,118,248
car,yolov8x,8265517869_53c5fb3eff_z.jpg,426,639,3,1,0.258082926,95,30,22.30046948,4.694835681,269,299,154,249
car,yolov8x,16982913298_aa90f2a62b_z.jpg,640,640,3,1,0.957767129,342,639,53.4375,99.84375,1,640,152,494
car,yolov8x,16982913298_aa90f2a62b_z.jpg,640,640,3,1,0.922400892,93,99,14.53125,15.46875,0,99,146,239
car,yolov8x,16982913298_aa90f2a62b_z.jpg,640,640,3,1,0.821926951,81,112,12.65625,17.5,528,640,133,214
car,yolov8x,16982913298_aa90f2a62b_z.jpg,640,640,3,1,0.742886305,59,159,9.21875,24.84375,60,219,137,196
car,yolov8x,16982913298_aa90f2a62b_z.jpg,640,640,3,1,0.655461609,34,61,5.3125,9.53125,3,64,140,174
car,yolov8x,4370423313_49f3722e85_z.jpg,480,640,3,1,0.95728749,310,557,64.58333333,87.03125,61,618,112,422
car,yolov8x,8032610600_1dd81d41a4_z.jpg,427,640,3,1,0.87752974,380,310,88.99297424,48.4375,1,311,10,390
car,yolov8x,82706249_bf54b24c4e_z.jpg,257,639,3,1,0.962925494,211,567,82.10116732,88.73239437,25,592,22,233
car,yolov8x,340359612_df41037e73_z.jpg,426,640,3,1,0.855986416,172,109,40.37558685,17.03125,0,109,82,254
car,yolov8x,340359612_df41037e73_z.jpg,426,640,3,1,0.813711107,93,75,21.83098592,11.71875,77,152,119,212
car,yolov8x,340359612_df41037e73_z.jpg,426,640,3,1,0.347696006,121,106,28.40375587,16.5625,534,640,107,228
car,yolov8x,340359612_df41037e73_z.jpg,426,640,3,1,0.27191475,92,87,21.59624413,13.59375,553,640,136,228
car,yolov8x,432591931_4789d0f0f1_z.jpg,480,640,3,1,0.954238951,149,187,31.04166667,29.21875,453,640,118,267
car,yolov8x,432591931_4789d0f0f1_z.jpg,480,640,3,1,0.931006312,140,105,29.16666667,16.40625,0,105,164,304
car,yolov8x,432591931_4789d0f0f1_z.jpg,480,640,3,1,0.804036677,155,328,32.29166667,51.25,113,441,125,280
car,yolov8x,6168484879_e6b9644722_z.jpg,427,640,3,1,0.974245548,257,541,60.18735363,84.53125,75,616,94,351
car,yolov8x,6410065163_fef2877544_z.jpg,444,640,3,1,0.946158588,333,594,75,92.8125,45,639,61,394
car,yolov8x,953262953_340a098204_z.jpg,427,640,3,1,0.962199569,220,622,51.52224824,97.1875,2,624,202,422
car,yolov8x,15038212434_9e0e575008_z.jpg,640,640,3,1,0.956905663,214,491,33.4375,76.71875,149,640,223,437
car,yolov8x,5099996575_32762aeb7f_z.jpg,480,640,3,1,0.959738076,382,536,79.58333333,83.75,72,608,50,432
car,yolov8x,342659307_d5d9d36af5_z.jpg,302,640,3,1,0.939759493,189,634,62.58278146,99.0625,2,636,107,296
car,yolov8x,3312304999_bc296f3260_z.jpg,369,639,3,1,0.863721311,266,621,72.08672087,97.18309859,0,621,59,325
car,yolov8x,13340204053_873cda4cef_z.jpg,359,639,3,1,0.708881557,247,562,68.80222841,87.94992175,37,599,40,287
car,yolov8x,5340010485_edeaa88c83_z.jpg,480,639,3,1,0.959673882,264,481,55,75.27386541,37,518,119,383
car,yolov8x,5340010485_edeaa88c83_z.jpg,480,639,3,1,0.932086945,159,194,33.125,30.3599374,445,639,94,253
car,yolov8x,5340010485_edeaa88c83_z.jpg,480,639,3,1,0.694406271,43,28,8.958333333,4.381846635,0,28,100,143
car,yolov8x,2525539133_73f08a9471_z.jpg,427,640,3,1,0.948746383,173,444,40.51522248,69.375,156,600,184,357
car,yolov8x,6431153899_9ac59a36b4_z.jpg,480,640,3,1,0.96916002,249,549,51.875,85.78125,51,600,198,447
car,yolov8x,16106543870_2f167db1e1_z.jpg,480,640,3,1,0.556710184,274,632,57.08333333,98.75,1,633,109,383
car,yolov8x,19577109682_a0282d8678_z.jpg,458,640,3,1,0.848089516,264,592,57.6419214,92.5,16,608,108,372
car,yolov8x,6010263871_df93fb6382_z.jpg,427,640,3,1,0.964859366,157,330,36.76814988,51.5625,0,330,135,292
car,yolov8x,6010263871_df93fb6382_z.jpg,427,640,3,1,0.935743868,140,160,32.78688525,25,480,640,140,280
car,yolov8x,6010263871_df93fb6382_z.jpg,427,640,3,1,0.889854074,76,165,17.79859485,25.78125,9,174,122,198
car,yolov8x,6010263871_df93fb6382_z.jpg,427,640,3,1,0.427826971,120,275,28.1030445,42.96875,306,581,89,209
car,yolov8x,6010263871_df93fb6382_z.jpg,427,640,3,1,0.482104242,19,13,4.449648712,2.03125,0,13,0,19
car,yolov8x,6010263871_df93fb6382_z.jpg,427,640,3,1,0.430392951,18,52,4.215456674,8.125,402,454,0,18
car,yolov8x,6010263871_df93fb6382_z.jpg,427,640,3,1,0.271550179,19,76,4.449648712,11.875,76,152,0,19
car,yolov8x,7110476047_267467ee68_z.jpg,450,640,3,1,0.902954221,72,109,16,17.03125,20,129,177,249
car,yolov8x,7110476047_267467ee68_z.jpg,450,640,3,1,0.900071979,322,472,71.55555556,73.75,93,565,88,410
car,yolov8x,7110476047_267467ee68_z.jpg,450,640,3,1,0.883101881,65,77,14.44444444,12.03125,563,640,154,219
car,yolov8x,7110476047_267467ee68_z.jpg,450,640,3,1,0.836012781,96,95,21.33333333,14.84375,538,633,164,260
car,yolov8x,7035751851_15d745cf2c_z.jpg,480,640,3,1,0.972960293,267,571,55.625,89.21875,47,618,108,375
car,yolov8x,7035751851_15d745cf2c_z.jpg,480,640,3,1,0.917206287,159,279,33.125,43.59375,0,279,101,260
car,yolov8x,7035751851_15d745cf2c_z.jpg,480,640,3,1,0.641166866,53,94,11.04166667,14.6875,0,94,101,154
car,yolov8x,3157735385_c9e7580f03_z.jpg,471,640,3,1,0.970104933,219,637,46.49681529,99.53125,1,638,230,449
car,yolov8x,3679100484_a8e3044e55_z.jpg,480,640,3,1,0.922365725,182,592,37.91666667,92.5,19,611,149,331
car,yolov8x,9238365388_d2bb1bb2e4_z.jpg,424,640,3,1,0.970607817,367,573,86.55660377,89.53125,1,574,7,374
car,yolov8x,9238365388_d2bb1bb2e4_z.jpg,424,640,3,1,0.95829308,214,465,50.47169811,72.65625,174,639,39,253
car,yolov8x,9238365388_d2bb1bb2e4_z.jpg,424,640,3,1,0.901569545,68,107,16.03773585,16.71875,533,640,57,125
car,yolov8x,14786765330_5d381d2451_z.jpg,480,640,3,1,0.953871548,315,557,65.625,87.03125,36,593,105,420
car,yolov8x,14786765330_5d381d2451_z.jpg,480,640,3,1,0.705327332,26,41,5.416666667,6.40625,249,290,129,155
car,yolov8x,14786765330_5d381d2451_z.jpg,480,640,3,1,0.691701591,41,16,8.541666667,2.5,624,640,176,217
car,yolov8x,14786765330_5d381d2451_z.jpg,480,640,3,1,0.414407372,58,51,12.08333333,7.96875,5,56,154,212
car,yolov8x,14786765330_5d381d2451_z.jpg,480,640,3,1,0.398347616,78,100,16.25,15.625,110,210,94,172
car,yolov8x,20795376805_7d3aabfce1_z.jpg,400,640,3,1,0.963105142,195,389,48.75,60.78125,104,493,133,328
car,yolov8x,9057859369_5a432fdfe1_z.jpg,427,640,3,1,0.974386215,313,518,73.30210773,80.9375,50,568,68,381
car,yolov8x,9057859369_5a432fdfe1_z.jpg,427,640,3,1,0.920340359,152,170,35.5971897,26.5625,470,640,25,177
car,yolov8x,9549882142_c59c04bac0_z.jpg,379,600,3,1,0.960347891,254,241,67.01846966,40.16666667,1,242,93,347
car,yolov8x,9549882142_c59c04bac0_z.jpg,379,600,3,1,0.95372647,243,198,64.11609499,33,401,599,73,316
car,yolov8x,9549882142_c59c04bac0_z.jpg,379,600,3,1,0.910667598,195,94,51.45118734,15.66666667,367,461,95,290
car,yolov8x,9549882142_c59c04bac0_z.jpg,379,600,3,1,0.905063868,185,167,48.81266491,27.83333333,125,292,103,288
car,yolov8x,5575004957_c281c5de1f_z.jpg,480,640,3,1,0.945253432,318,532,66.25,83.125,52,584,111,429
car,yolov8x,5575004957_c281c5de1f_z.jpg,480,640,3,1,0.824880242,150,137,31.25,21.40625,503,640,119,269
car,yolov8x,2468082692_49ec682990_z.jpg,480,640,3,0,0,0,0,0,0,0,0,0,0
car,yolov8x,5466970559_0f7b06bcd6_z.jpg,427,640,3,1,0.974938989,375,590,87.82201405,92.1875,30,620,29,404
car,yolov8x,5466970559_0f7b06bcd6_z.jpg,427,640,3,1,0.679446757,124,79,29.03981265,12.34375,561,640,96,220
car,yolov8x,5466970559_0f7b06bcd6_z.jpg,427,640,3,1,0.478649914,77,90,18.03278689,14.0625,28,118,0,77
car,yolov8x,5466970559_0f7b06bcd6_z.jpg,427,640,3,1,0.475856394,100,51,23.41920375,7.96875,0,51,153,253
car,yolov8x,5466970559_0f7b06bcd6_z.jpg,427,640,3,1,0.461645484,21,20,4.918032787,3.125,620,640,83,104
car,yolov8x,5466970559_0f7b06bcd6_z.jpg,427,640,3,1,0.390422255,18,60,4.215456674,9.375,573,633,86,104
car,yolov8x,5466970559_0f7b06bcd6_z.jpg,427,640,3,1,0.300632626,120,57,28.1030445,8.90625,583,640,101,221
car,yolov8x,2918687630_5108e3e2ab_z.jpg,427,640,3,0,0,0,0,0,0,0,0,0,0
car,yolov8x,5333910985_ea4e62f651_z.jpg,480,640,3,0,0,0,0,0,0,0,0,0,0
car,yolov8x,211850545_7f670901ab_z.jpg,426,640,3,1,0.658719242,418,634,98.12206573,99.0625,3,637,2,420
car,yolov8x,3499391979_76c0c01a3c_z.jpg,427,640,3,1,0.95747596,118,300,27.63466042,46.875,85,385,245,363
car,yolov8x,6097504753_2971a9eaa6_z.jpg,480,640,3,1,0.833741903,144,389,30,60.78125,235,624,33,177
car,yolov8x,6097504753_2971a9eaa6_z.jpg,480,640,3,1,0.415359706,260,467,54.16666667,72.96875,72,539,56,316
car,yolov8x,6097504753_2971a9eaa6_z.jpg,480,640,3,1,0.678892732,381,324,79.375,50.625,1,325,98,479
car,yolov8x,6097504753_2971a9eaa6_z.jpg,480,640,3,1,0.546850145,241,253,50.20833333,39.53125,386,639,238,479
car,yolov8x,2166320847_63a04a9303_z.jpg,427,640,3,0,0,0,0,0,0,0,0,0,0
car,yolov8x,19299023856_077e45c472_z.jpg,407,639,3,1,0.857132733,111,95,27.27272727,14.86697966,544,639,57,168
car,yolov8x,19299023856_077e45c472_z.jpg,407,639,3,1,0.697796345,271,535,66.58476658,83.72456964,45,580,71,342
car,yolov8x,3413987789_b607473327_z.jpg,480,640,3,1,0.903555453,48,77,10,12.03125,563,640,128,176
car,yolov8x,3413987789_b607473327_z.jpg,480,640,3,1,0.663977087,17,12,3.541666667,1.875,0,12,126,143
car,yolov8x,13314143603_95d63b5748_z.jpg,480,640,3,1,0.868522644,78,201,16.25,31.40625,30,231,71,149
car,yolov8x,13314143603_95d63b5748_z.jpg,480,640,3,1,0.797967494,395,560,82.29166667,87.5,64,624,63,458
car,yolov8x,13314143603_95d63b5748_z.jpg,480,640,3,1,0.753620267,48,17,10,2.65625,623,640,90,138
car,yolov8x,13314143603_95d63b5748_z.jpg,480,640,3,1,0.745189965,47,40,9.791666667,6.25,600,640,75,122
car,yolov8x,13314143603_95d63b5748_z.jpg,480,640,3,1,0.675979018,56,110,11.66666667,17.1875,231,341,72,128
car,yolov8x,13314143603_95d63b5748_z.jpg,480,640,3,1,0.286179781,16,41,3.333333333,6.40625,234,275,74,90
car,yolov8x,7782123174_dbda292cef_z.jpg,480,640,3,1,0.898921013,125,96,26.04166667,15,544,640,215,340
car,yolov8x,15196353300_2dcb1a1948_z.jpg,426,640,3,1,0.883347571,23,67,5.399061033,10.46875,543,610,111,134
car,yolov8x,15196353300_2dcb1a1948_z.jpg,426,640,3,1,0.864277184,218,331,51.17370892,51.71875,142,473,116,334
car,yolov8x,15196353300_2dcb1a1948_z.jpg,426,640,3,1,0.615543604,17,17,3.990610329,2.65625,0,17,112,129
car,yolov8x,15196353300_2dcb1a1948_z.jpg,426,640,3,1,0.589237988,14,83,3.286384977,12.96875,306,389,108,122
car,yolov8x,15196353300_2dcb1a1948_z.jpg,426,640,3,1,0.452363372,13,63,3.051643192,9.84375,326,389,108,121
car,yolov8x,15196353300_2dcb1a1948_z.jpg,426,640,3,1,0.252330095,17,32,3.990610329,5,0,32,112,129
cat,yolov8l,12570366253_52905ec5a1_z.jpg,476,640,3,1,0.888877869,457,453,96.00840336,70.78125,32,485,15,472
cat,yolov8l,11101898274_dcf6061b20_z.jpg,427,640,3,1,0.962795138,387,435,90.6323185,67.96875,128,563,15,402
cat,yolov8l,11101898274_dcf6061b20_z.jpg,427,640,3,1,0.872021973,117,245,27.40046838,38.28125,283,528,267,384
cat,yolov8l,2177230709_086e9d23d8_z.jpg,422,639,3,1,0.929356396,322,638,76.30331754,99.84350548,1,639,64,386
cat,yolov8l,3029397040_d35cf11083_z.jpg,428,639,3,1,0.950799882,363,638,84.81308411,99.84350548,1,639,58,421
cat,yolov8l,1240686712_fbccf26b7f_z.jpg,427,640,3,1,0.82574904,387,414,90.6323185,64.6875,107,521,0,387
cat,yolov8l,138805025_80da2e3a82_z.jpg,480,640,3,1,0.946569741,332,593,69.16666667,92.65625,47,640,26,358
cat,yolov8l,15516450642_4fffe9be37_z.jpg,640,640,3,1,0.969897747,528,514,82.5,80.3125,126,640,112,640
cat,yolov8l,18285977255_534ec8e749_z.jpg,427,640,3,1,0.963172913,419,460,98.1264637,71.875,180,640,1,420
cat,yolov8l,9372235876_d7d69f1790_z.jpg,498,640,3,1,0.960407019,482,526,96.78714859,82.1875,1,527,11,493
cat,yolov8l,7175939730_9a03853d4c_z.jpg,480,640,3,1,0.84417361,171,128,35.625,20,231,359,116,287
cat,yolov8l,4991188769_8642331e2c_z.jpg,448,640,3,1,0.953401923,427,583,95.3125,91.09375,25,608,16,443
cat,yolov8l,20264405486_14055e8288_z.jpg,480,640,3,1,0.951987445,393,527,81.875,82.34375,113,640,62,455
cat,yolov8l,9002629162_51388d1396_z.jpg,427,640,3,1,0.958904743,420,584,98.36065574,91.25,55,639,0,420
cat,yolov8l,15589191923_99889a9f83_z.jpg,640,480,3,1,0.95028019,639,407,99.84375,84.79166667,72,479,0,639
cat,yolov8l,7685782426_d3615820e9_z.jpg,427,640,3,1,0.961138785,420,622,98.36065574,97.1875,18,640,0,420
cat,yolov8l,5974549533_83d56b822d_z.jpg,424,640,3,1,0.836860716,398,617,93.86792453,96.40625,0,617,1,399
cat,yolov8l,16278721974_968bd6bbcf_z.jpg,359,639,3,1,0.954003036,199,291,55.43175487,45.5399061,229,520,110,309
cat,yolov8l,3582713912_3d9ac5ecc9_z.jpg,480,640,3,1,0.946558177,433,511,90.20833333,79.84375,128,639,46,479
cat,yolov8l,2215395014_24a2f8184c_z.jpg,512,639,3,1,0.594126225,281,500,54.8828125,78.24726135,29,529,1,282
cat,yolov8l,2215395014_24a2f8184c_z.jpg,512,639,3,1,0.374515384,501,637,97.8515625,99.68701095,1,638,2,503
cat,yolov8l,2215395014_24a2f8184c_z.jpg,512,639,3,1,0.372451037,272,637,53.125,99.68701095,1,638,233,505
cat,yolov8l,8213118547_f274c67e93_z.jpg,427,640,3,1,0.950260162,378,374,88.52459016,58.4375,1,375,43,421
cat,yolov8l,2230295891_a68077f047_z.jpg,430,640,3,1,0.947567523,359,399,83.48837209,62.34375,0,399,66,425
cat,yolov8l,2230295891_a68077f047_z.jpg,430,640,3,1,0.926637352,300,297,69.76744186,46.40625,343,640,122,422
cat,yolov8l,15837810787_14c16de452_z.jpg,425,639,3,1,0.931806445,259,397,60.94117647,62.12832551,167,564,86,345
cat,yolov8l,3607850542_a3577913d7_z.jpg,480,640,3,1,0.928940117,478,628,99.58333333,98.125,2,630,1,479
cat,yolov8l,1492095547_3a48dbc70b_z.jpg,480,640,3,1,0.943932176,350,561,72.91666667,87.65625,78,639,130,480
cat,yolov8l,5549228224_a42f7d5300_z.jpg,425,640,3,1,0.856279075,417,638,98.11764706,99.6875,1,639,1,418
cat,yolov8l,6455179889_6db5a93bfa_z.jpg,505,640,3,1,0.920766473,498,519,98.61386139,81.09375,0,519,0,498
cat,yolov8l,225687978_713319e6c1_z.jpg,640,427,3,0,0,0,0,0,0,0,0,0,0
cat,yolov8l,3360078465_de3ceaa137_z.jpg,640,426,3,1,0.963559151,596,400,93.125,93.89671362,1,401,43,639
cat,yolov8l,5436402112_3aee3141a7_z.jpg,518,640,3,1,0.959390581,458,296,88.41698842,46.25,112,408,55,513
cat,yolov8l,4730790029_bdc24fcb8c_z.jpg,428,639,3,1,0.960042417,422,461,98.59813084,72.14397496,115,576,0,422
cat,yolov8l,16599186017_25f46b7511_z.jpg,640,640,3,1,0.94386971,634,640,99.0625,100,0,640,4,638
cat,yolov8l,2538610337_8cbdfed59e_z.jpg,640,590,3,1,0.957449019,607,561,94.84375,95.08474576,0,561,32,639
cat,yolov8l,2218544892_0ae9cb42da_z.jpg,480,640,3,1,0.963274896,478,458,99.58333333,71.5625,181,639,1,479
cat,yolov8l,219320127_ff9873aaf5_z.jpg,480,640,3,1,0.960419238,422,533,87.91666667,83.28125,0,533,54,476
cat,yolov8l,1110261834_4068e20626_z.jpg,480,640,3,1,0.899680436,435,393,90.625,61.40625,114,507,45,480
cat,yolov8l,1110261834_4068e20626_z.jpg,480,640,3,1,0.473421037,477,598,99.375,93.4375,1,599,1,478
cat,yolov8l,15237426722_a51d199f2f_z.jpg,520,640,3,1,0.958112478,429,484,82.5,75.625,132,616,66,495
cat,yolov8l,3372528428_1fdbd7e39c_z.jpg,640,480,3,1,0.976150513,637,479,99.53125,99.79166667,1,480,2,639
cat,yolov8l,3703720579_4a2cf4af15_z.jpg,478,640,3,1,0.955554962,362,286,75.73221757,44.6875,8,294,65,427
cat,yolov8l,2206074222_69cc088500_z.jpg,426,640,3,1,0.932948172,381,638,89.43661972,99.6875,1,639,38,419
cat,yolov8l,4226351112_a6f67d031e_z.jpg,480,640,3,1,0.935259521,473,374,98.54166667,58.4375,211,585,7,480
cat,yolov8l,17594682014_fcd2ac5ca3_z.jpg,480,640,3,1,0.913440943,411,640,85.625,100,0,640,41,452
cat,yolov8l,4743123794_5c502eaee7_z.jpg,640,427,3,1,0.913715303,635,426,99.21875,99.76580796,1,427,1,636
cat,yolov8l,6100259603_28a9794ed5_z.jpg,427,640,3,1,0.938258171,406,569,95.08196721,88.90625,70,639,15,421
cat,yolov8l,4781592393_07d35524ef_z.jpg,640,427,3,1,0.961111605,577,422,90.15625,98.82903981,4,426,63,640
cat,yolov8l,858829152_629399f0a4_z.jpg,640,480,3,1,0.960381508,498,412,77.8125,85.83333333,0,412,87,585
cat,yolov8l,2861862980_8aab1934f0_z.jpg,480,640,3,1,0.907332778,466,600,97.08333333,93.75,21,621,14,480
cat,yolov8l,12988804124_bbea6d94c0_z.jpg,428,640,3,1,0.925891876,408,570,95.3271028,89.0625,70,640,10,418
cat,yolov8l,1980856023_6049619444_z.jpg,480,640,3,1,0.80589509,478,551,99.58333333,86.09375,1,552,1,479
cat,yolov8l,33580840_a67c2b796a_z.jpg,480,640,3,1,0.97477752,475,459,98.95833333,71.71875,1,460,4,479
cat,yolov8l,14711690133_019fe56eb5_z.jpg,427,640,3,1,0.927942514,405,543,94.84777518,84.84375,96,639,1,406
cat,yolov8l,258460789_c4baeb300a_z.jpg,472,639,3,1,0.939296246,448,425,94.91525424,66.51017214,0,425,18,466
cat,yolov8l,9478594118_5861e54c87_z.jpg,480,640,3,1,0.723914862,349,638,72.70833333,99.6875,2,640,1,350
cat,yolov8l,6924362656_d86bedc2e4_z.jpg,480,640,3,1,0.873076499,422,492,87.91666667,76.875,43,535,3,425
cat,yolov8l,1570513225_265b529538_z.jpg,429,640,3,1,0.930926681,309,531,72.02797203,82.96875,19,550,115,424
cat,yolov8l,7664570690_6ab2f0ab5d_z.jpg,480,640,3,1,0.937278211,479,566,99.79166667,88.4375,73,639,0,479
cat,yolov8l,9573099282_bbc0b12c70_z.jpg,487,640,3,1,0.962083161,479,581,98.35728953,90.78125,58,639,1,480
cat,yolov8l,2709706154_32ff27825a_z.jpg,480,640,3,1,0.90213114,479,639,99.79166667,99.84375,0,639,1,480
cat,yolov8l,2244176071_615b055c30_z.jpg,640,480,3,1,0.939223826,638,416,99.6875,86.66666667,54,470,1,639
cat,yolov8l,207320225_2446b6cf11_z.jpg,427,640,3,1,0.936717212,332,300,77.75175644,46.875,237,537,90,422
cat,yolov8l,207320225_2446b6cf11_z.jpg,427,640,3,1,0.929690242,188,225,44.02810304,35.15625,137,362,98,286
cat,yolov8l,3069852951_85b984b709_z.jpg,474,639,3,1,0.955934584,466,637,98.31223629,99.68701095,1,638,2,468
cat,yolov8l,2999108747_2b1e0ac45f_z.jpg,640,480,3,1,0.940722406,507,332,79.21875,69.16666667,84,416,70,577
cat,yolov8l,80536950_5993089209_z.jpg,480,640,3,1,0.915426254,478,627,99.58333333,97.96875,1,628,1,479
cat,yolov8l,438887381_0a2a4e97e4_z.jpg,640,428,3,1,0.965255618,591,415,92.34375,96.96261682,1,416,48,639
cat,yolov8l,1428837563_12ec867e05_z.jpg,480,640,3,1,0.914795697,387,326,80.625,50.9375,166,492,34,421
cat,yolov8l,422908475_7be8fe7338_z.jpg,640,567,3,1,0.935614347,582,507,90.9375,89.41798942,1,508,57,639
cat,yolov8l,15584457029_80b75274db_z.jpg,427,640,3,1,0.962653875,300,231,70.25761124,36.09375,186,417,106,406
cat,yolov8l,449567850_48a3c60a6f_z.jpg,398,640,3,1,0.934472561,373,640,93.71859296,100,0,640,17,390
cat,yolov8l,11335325886_75cf456ea8_z.jpg,580,640,3,1,0.953278542,523,639,90.17241379,99.84375,0,639,50,573
cat,yolov8l,5048937296_7c707f1d71_z.jpg,558,640,3,1,0.941237509,435,453,77.95698925,70.78125,186,639,64,499
cat,yolov8l,15617633365_316afedb8d_z.jpg,640,640,3,1,0.90048939,637,514,99.53125,80.3125,125,639,0,637
cat,yolov8l,6835338988_c013b40c94_z.jpg,441,640,3,1,0.935070038,419,513,95.01133787,80.15625,40,553,17,436
cat,yolov8l,412652687_4d6cb46129_z.jpg,640,463,3,1,0.75989002,478,441,74.6875,95.24838013,19,460,162,640
cat,yolov8l,6180200475_fda2795252_z.jpg,640,480,3,1,0.945592999,638,455,99.6875,94.79166667,0,455,1,639
cat,yolov8l,2553120516_dd48754dc4_z.jpg,424,640,3,1,0.788065016,390,485,91.98113208,75.78125,154,639,0,390
cat,yolov8l,8523144329_569f1781b3_z.jpg,519,640,3,1,0.925532281,511,515,98.45857418,80.46875,25,540,0,511
cat,yolov8l,31792151_e1e4c47427_z.jpg,423,640,3,1,0.922356665,332,306,78.48699764,47.8125,334,640,13,345
cat,yolov8l,31792151_e1e4c47427_z.jpg,423,640,3,1,0.92098248,324,610,76.59574468,95.3125,29,639,93,417
cat,yolov8l,12041194676_da91e0d068_z.jpg,427,640,3,1,0.94267261,375,475,87.82201405,74.21875,164,639,47,422
cat,yolov8l,2718097307_1fb900f17a_z.jpg,427,640,3,1,0.922487915,206,394,48.24355972,61.5625,189,583,93,299
cat,yolov8l,7019541657_00e6c7a645_z.jpg,419,640,3,1,0.842523277,366,375,87.35083532,58.59375,145,520,32,398
cat,yolov8l,2667833832_bf9ddddac5_z.jpg,640,480,3,1,0.97155273,593,386,92.65625,80.41666667,11,397,33,626
cat,yolov8l,6062750656_89284163db_z.jpg,426,640,3,1,0.856197238,84,88,19.71830986,13.75,262,350,311,395
cat,yolov8l,6062750656_89284163db_z.jpg,426,640,3,1,0.807624996,96,81,22.53521127,12.65625,442,523,39,135
cat,yolov8l,6062750656_89284163db_z.jpg,426,640,3,1,0.790761292,107,106,25.11737089,16.5625,458,564,221,328
cat,yolov8l,777472482_5eae8617bd_z.jpg,639,478,3,1,0.943170905,622,441,97.33959311,92.25941423,27,468,1,623
cat,yolov8l,3632975096_ec47d16f37_z.jpg,479,640,3,1,0.936031759,438,585,91.44050104,91.40625,54,639,0,438
cat,yolov8l,3844809782_aa1ce17781_z.jpg,480,640,3,1,0.861975193,473,421,98.54166667,65.78125,4,425,7,480
cat,yolov8l,3844809782_aa1ce17781_z.jpg,480,640,3,1,0.701237261,431,339,89.79166667,52.96875,297,636,49,480
cat,yolov8l,8464801471_b2b61acc7b_z.jpg,427,640,3,1,0.954045594,420,635,98.36065574,99.21875,1,636,0,420
cat,yolov8l,8526465743_29a9320d16_z.jpg,612,612,3,1,0.925177336,610,450,99.67320261,73.52941176,61,511,1,611
cat,yolov8l,3283350420_d2b4b8fef3_z.jpg,427,640,3,1,0.948895931,393,617,92.03747073,96.40625,23,640,26,419
cat,yolov8l,3959888385_3580cd572c_z.jpg,639,494,3,1,0.883273125,439,480,68.70109546,97.1659919,2,482,75,514
cat,yolov8l,3895919953_9ba2530425_z.jpg,425,640,3,1,0.959820032,355,395,83.52941176,61.71875,0,395,65,420
cat,yolov8m,12570366253_52905ec5a1_z.jpg,476,640,3,1,0.846497893,462,421,97.05882353,65.78125,21,442,11,473
cat,yolov8m,11101898274_dcf6061b20_z.jpg,427,640,3,1,0.958328426,385,435,90.16393443,67.96875,130,565,17,402
cat,yolov8m,11101898274_dcf6061b20_z.jpg,427,640,3,1,0.327049911,114,246,26.69789227,38.4375,283,529,270,384
cat,yolov8m,2177230709_086e9d23d8_z.jpg,422,639,3,1,0.91127193,330,639,78.19905213,100,0,639,58,388
cat,yolov8m,3029397040_d35cf11083_z.jpg,428,639,3,1,0.948695958,367,638,85.74766355,99.84350548,1,639,56,423
cat,yolov8m,1240686712_fbccf26b7f_z.jpg,427,640,3,1,0.925310612,383,415,89.69555035,64.84375,108,523,0,383
cat,yolov8m,138805025_80da2e3a82_z.jpg,480,640,3,1,0.92765981,335,595,69.79166667,92.96875,45,640,23,358
cat,yolov8m,15516450642_4fffe9be37_z.jpg,640,640,3,1,0.94980073,526,511,82.1875,79.84375,129,640,113,639
cat,yolov8m,18285977255_534ec8e749_z.jpg,427,640,3,1,0.934564292,419,459,98.1264637,71.71875,180,639,1,420
cat,yolov8m,9372235876_d7d69f1790_z.jpg,498,640,3,1,0.960710287,483,522,96.98795181,81.5625,2,524,9,492
cat,yolov8m,7175939730_9a03853d4c_z.jpg,480,640,3,1,0.751903713,170,152,35.41666667,23.75,212,364,117,287
cat,yolov8m,4991188769_8642331e2c_z.jpg,448,640,3,1,0.955487072,425,585,94.86607143,91.40625,22,607,17,442
cat,yolov8m,20264405486_14055e8288_z.jpg,480,640,3,1,0.942068875,394,526,82.08333333,82.1875,113,639,61,455
cat,yolov8m,9002629162_51388d1396_z.jpg,427,640,3,1,0.918421447,417,580,97.65807963,90.625,58,638,3,420
cat,yolov8m,15589191923_99889a9f83_z.jpg,640,480,3,1,0.941992581,639,406,99.84375,84.58333333,73,479,0,639
cat,yolov8m,7685782426_d3615820e9_z.jpg,427,640,3,1,0.9513219,420,616,98.36065574,96.25,21,637,0,420
cat,yolov8m,5974549533_83d56b822d_z.jpg,424,640,3,1,0.8512339,403,633,95.04716981,98.90625,2,635,1,404
cat,yolov8m,16278721974_968bd6bbcf_z.jpg,359,639,3,1,0.956244469,199,292,55.43175487,45.69640063,228,520,110,309
cat,yolov8m,3582713912_3d9ac5ecc9_z.jpg,480,640,3,1,0.926371992,434,512,90.41666667,80,127,639,46,480
cat,yolov8m,2215395014_24a2f8184c_z.jpg,512,639,3,1,0.672235072,500,633,97.65625,99.06103286,3,636,0,500
cat,yolov8m,2215395014_24a2f8184c_z.jpg,512,639,3,1,0.645749807,303,501,59.1796875,78.40375587,31,532,0,303
cat,yolov8m,2215395014_24a2f8184c_z.jpg,512,639,3,1,0.3479352,268,635,52.34375,99.37402191,2,637,236,504
cat,yolov8m,8213118547_f274c67e93_z.jpg,427,640,3,1,0.961641014,376,373,88.05620609,58.28125,1,374,45,421
cat,yolov8m,2230295891_a68077f047_z.jpg,430,640,3,1,0.95013231,359,399,83.48837209,62.34375,1,400,66,425
cat,yolov8m,2230295891_a68077f047_z.jpg,430,640,3,1,0.903571725,305,289,70.93023256,45.15625,351,640,120,425
cat,yolov8m,15837810787_14c16de452_z.jpg,425,639,3,1,0.928775787,260,393,61.17647059,61.50234742,169,562,86,346
cat,yolov8m,3607850542_a3577913d7_z.jpg,480,640,3,1,0.922034502,475,613,98.95833333,95.78125,1,614,4,479
cat,yolov8m,1492095547_3a48dbc70b_z.jpg,480,640,3,1,0.938742101,351,564,73.125,88.125,76,640,129,480
cat,yolov8m,5549228224_a42f7d5300_z.jpg,425,640,3,1,0.55154705,415,636,97.64705882,99.375,2,638,2,417
cat,yolov8m,6455179889_6db5a93bfa_z.jpg,505,640,3,1,0.91062361,498,520,98.61386139,81.25,1,521,0,498
cat,yolov8m,225687978_713319e6c1_z.jpg,640,427,3,1,0.566379964,636,423,99.375,99.06323185,3,426,1,637
cat,yolov8m,3360078465_de3ceaa137_z.jpg,640,426,3,1,0.961143851,596,401,93.125,94.1314554,2,403,43,639
cat,yolov8m,5436402112_3aee3141a7_z.jpg,518,640,3,1,0.949103355,457,295,88.22393822,46.09375,112,407,56,513
cat,yolov8m,4730790029_bdc24fcb8c_z.jpg,428,639,3,1,0.825755715,423,480,98.8317757,75.11737089,113,593,0,423
cat,yolov8m,16599186017_25f46b7511_z.jpg,640,640,3,1,0.910620034,629,637,98.28125,99.53125,3,640,5,634
cat,yolov8m,2538610337_8cbdfed59e_z.jpg,640,590,3,1,0.944174051,607,556,94.84375,94.23728814,4,560,32,639
cat,yolov8m,2218544892_0ae9cb42da_z.jpg,480,640,3,1,0.959433496,479,457,99.79166667,71.40625,182,639,0,479
cat,yolov8m,219320127_ff9873aaf5_z.jpg,480,640,3,1,0.951610327,421,531,87.70833333,82.96875,1,532,52,473
cat,yolov8m,1110261834_4068e20626_z.jpg,480,640,3,1,0.775420845,446,396,92.91666667,61.875,113,509,33,479
cat,yolov8m,1110261834_4068e20626_z.jpg,480,640,3,1,0.515173376,476,534,99.16666667,83.4375,3,537,1,477
cat,yolov8m,15237426722_a51d199f2f_z.jpg,520,640,3,1,0.951385558,432,486,83.07692308,75.9375,132,618,65,497
cat,yolov8m,3372528428_1fdbd7e39c_z.jpg,640,480,3,1,0.948032439,637,478,99.53125,99.58333333,1,479,2,639
cat,yolov8m,3703720579_4a2cf4af15_z.jpg,478,640,3,1,0.9502424,361,289,75.52301255,45.15625,7,296,65,426
cat,yolov8m,2206074222_69cc088500_z.jpg,426,640,3,1,0.924821913,376,634,88.2629108,99.0625,1,635,43,419
cat,yolov8m,4226351112_a6f67d031e_z.jpg,480,640,3,1,0.94955498,471,374,98.125,58.4375,212,586,8,479
cat,yolov8m,17594682014_fcd2ac5ca3_z.jpg,480,640,3,1,0.911970377,412,631,85.83333333,98.59375,9,640,41,453
cat,yolov8m,4743123794_5c502eaee7_z.jpg,640,427,3,1,0.878543854,617,427,96.40625,100,0,427,1,618
cat,yolov8m,6100259603_28a9794ed5_z.jpg,427,640,3,1,0.921411037,404,499,94.61358314,77.96875,139,638,17,421
cat,yolov8m,4781592393_07d35524ef_z.jpg,640,427,3,1,0.944884598,575,412,89.84375,96.48711944,12,424,63,638
cat,yolov8m,858829152_629399f0a4_z.jpg,640,480,3,1,0.895448089,493,411,77.03125,85.625,1,412,90,583
cat,yolov8m,2861862980_8aab1934f0_z.jpg,480,640,3,1,0.940568209,465,600,96.875,93.75,21,621,15,480
cat,yolov8m,12988804124_bbea6d94c0_z.jpg,428,640,3,1,0.889665127,409,591,95.56074766,92.34375,49,640,9,418
cat,yolov8m,1980856023_6049619444_z.jpg,480,640,3,1,0.898412645,478,633,99.58333333,98.90625,5,638,1,479
cat,yolov8m,33580840_a67c2b796a_z.jpg,480,640,3,1,0.96251756,474,459,98.75,71.71875,1,460,5,479
cat,yolov8m,14711690133_019fe56eb5_z.jpg,427,640,3,1,0.917962134,404,542,94.61358314,84.6875,97,639,1,405
cat,yolov8m,258460789_c4baeb300a_z.jpg,472,639,3,1,0.934902608,446,420,94.49152542,65.72769953,1,421,19,465
cat,yolov8m,9478594118_5861e54c87_z.jpg,480,640,3,1,0.741434157,338,637,70.41666667,99.53125,2,639,26,364
cat,yolov8m,6924362656_d86bedc2e4_z.jpg,480,640,3,1,0.76234442,421,496,87.70833333,77.5,39,535,2,423
cat,yolov8m,1570513225_265b529538_z.jpg,429,640,3,1,0.877551138,309,545,72.02797203,85.15625,22,567,115,424
cat,yolov8m,7664570690_6ab2f0ab5d_z.jpg,480,640,3,1,0.921030939,477,561,99.375,87.65625,78,639,2,479
cat,yolov8m,9573099282_bbc0b12c70_z.jpg,487,640,3,1,0.950021029,474,583,97.33059548,91.09375,56,639,7,481
cat,yolov8m,9573099282_bbc0b12c70_z.jpg,487,640,3,1,0.276210487,210,238,43.1211499,37.1875,402,640,0,210
cat,yolov8m,2709706154_32ff27825a_z.jpg,480,640,3,1,0.63548857,478,639,99.58333333,99.84375,0,639,1,479
cat,yolov8m,2244176071_615b055c30_z.jpg,640,480,3,1,0.925792813,622,409,97.1875,85.20833333,54,463,16,638
cat,yolov8m,207320225_2446b6cf11_z.jpg,427,640,3,1,0.937600315,331,299,77.5175644,46.71875,238,537,90,421
cat,yolov8m,207320225_2446b6cf11_z.jpg,427,640,3,1,0.917481661,189,225,44.26229508,35.15625,137,362,97,286
cat,yolov8m,3069852951_85b984b709_z.jpg,474,639,3,1,0.882680595,466,637,98.31223629,99.68701095,1,638,1,467
cat,yolov8m,2999108747_2b1e0ac45f_z.jpg,640,480,3,1,0.896062672,518,351,80.9375,73.125,64,415,70,588
cat,yolov8m,80536950_5993089209_z.jpg,480,640,3,1,0.889607668,477,629,99.375,98.28125,2,631,1,478
cat,yolov8m,438887381_0a2a4e97e4_z.jpg,640,428,3,1,0.949445546,587,413,91.71875,96.4953271,2,415,51,638
cat,yolov8m,1428837563_12ec867e05_z.jpg,480,640,3,1,0.948631942,390,328,81.25,51.25,163,491,34,424
cat,yolov8m,422908475_7be8fe7338_z.jpg,640,567,3,1,0.939495206,585,500,91.40625,88.18342152,0,500,53,638
cat,yolov8m,15584457029_80b75274db_z.jpg,427,640,3,1,0.95950681,299,229,70.0234192,35.78125,187,416,107,406
cat,yolov8m,449567850_48a3c60a6f_z.jpg,398,640,3,1,0.931101203,374,638,93.96984925,99.6875,2,640,15,389
cat,yolov8m,11335325886_75cf456ea8_z.jpg,580,640,3,1,0.920208812,526,637,90.68965517,99.53125,1,638,49,575
cat,yolov8m,5048937296_7c707f1d71_z.jpg,558,640,3,1,0.946467519,435,453,77.95698925,70.78125,185,638,64,499
cat,yolov8m,15617633365_316afedb8d_z.jpg,640,640,3,1,0.903841794,637,514,99.53125,80.3125,123,637,1,638
cat,yolov8m,6835338988_c013b40c94_z.jpg,441,640,3,1,0.94727695,422,517,95.69160998,80.78125,38,555,15,437
cat,yolov8m,412652687_4d6cb46129_z.jpg,640,463,3,1,0.926750183,480,439,75,94.81641469,23,462,159,639
cat,yolov8m,6180200475_fda2795252_z.jpg,640,480,3,1,0.89355725,637,454,99.53125,94.58333333,2,456,1,638
cat,yolov8m,2553120516_dd48754dc4_z.jpg,424,640,3,1,0.722116649,385,369,90.80188679,57.65625,162,531,0,385
cat,yolov8m,8523144329_569f1781b3_z.jpg,519,640,3,1,0.945017636,511,510,98.45857418,79.6875,29,539,0,511
cat,yolov8m,31792151_e1e4c47427_z.jpg,423,640,3,1,0.904009819,325,606,76.8321513,94.6875,33,639,92,417
cat,yolov8m,31792151_e1e4c47427_z.jpg,423,640,3,1,0.825110972,330,307,78.0141844,47.96875,332,639,14,344
cat,yolov8m,12041194676_da91e0d068_z.jpg,427,640,3,1,0.906471431,373,461,87.35362998,72.03125,172,633,48,421
cat,yolov8m,2718097307_1fb900f17a_z.jpg,427,640,3,1,0.951522946,205,396,48.00936768,61.875,190,586,93,298
cat,yolov8m,7019541657_00e6c7a645_z.jpg,419,640,3,1,0.804695427,367,375,87.58949881,58.59375,144,519,32,399
cat,yolov8m,2667833832_bf9ddddac5_z.jpg,640,480,3,1,0.955182672,587,386,91.71875,80.41666667,12,398,40,627
cat,yolov8m,6062750656_89284163db_z.jpg,426,640,3,1,0.748121619,109,98,25.58685446,15.3125,466,564,220,329
cat,yolov8m,6062750656_89284163db_z.jpg,426,640,3,1,0.732907891,91,83,21.36150235,12.96875,441,524,40,131
cat,yolov8m,6062750656_89284163db_z.jpg,426,640,3,1,0.712212741,86,85,20.18779343,13.28125,264,349,310,396
cat,yolov8m,777472482_5eae8617bd_z.jpg,639,478,3,1,0.951062799,630,446,98.5915493,93.30543933,29,475,0,630
cat,yolov8m,3632975096_ec47d16f37_z.jpg,479,640,3,1,0.935066223,437,582,91.23173278,90.9375,57,639,1,438
cat,yolov8m,3844809782_aa1ce17781_z.jpg,480,640,3,1,0.844137609,474,424,98.75,66.25,6,430,6,480
cat,yolov8m,3844809782_aa1ce17781_z.jpg,480,640,3,1,0.790612698,430,332,89.58333333,51.875,305,637,49,479
cat,yolov8m,8464801471_b2b61acc7b_z.jpg,427,640,3,1,0.923381031,420,629,98.36065574,98.28125,3,632,1,421
cat,yolov8m,8526465743_29a9320d16_z.jpg,612,612,3,1,0.836893678,610,431,99.67320261,70.4248366,81,512,1,611
cat,yolov8m,3283350420_d2b4b8fef3_z.jpg,427,640,3,1,0.934158385,392,622,91.80327869,97.1875,17,639,27,419
cat,yolov8m,3959888385_3580cd572c_z.jpg,639,494,3,1,0.924058855,442,486,69.17057903,98.3805668,6,492,74,516
cat,yolov8m,3895919953_9ba2530425_z.jpg,425,640,3,1,0.947372258,353,392,83.05882353,61.25,1,393,66,419
cat,yolov8n,12570366253_52905ec5a1_z.jpg,476,640,3,1,0.798556328,453,445,95.16806723,69.53125,40,485,15,468
cat,yolov8n,11101898274_dcf6061b20_z.jpg,427,640,3,1,0.810986876,395,479,92.5058548,74.84375,86,565,9,404
cat,yolov8n,2177230709_086e9d23d8_z.jpg,422,639,3,1,0.886511981,278,628,65.87677725,98.27856025,2,630,78,356
cat,yolov8n,3029397040_d35cf11083_z.jpg,428,639,3,1,0.870787799,378,639,88.31775701,100,0,639,50,428
cat,yolov8n,1240686712_fbccf26b7f_z.jpg,427,640,3,1,0.804481983,412,438,96.48711944,68.4375,90,528,0,412
cat,yolov8n,138805025_80da2e3a82_z.jpg,480,640,3,1,0.870163381,338,585,70.41666667,91.40625,54,639,22,360
cat,yolov8n,15516450642_4fffe9be37_z.jpg,640,640,3,1,0.879651666,524,518,81.875,80.9375,122,640,115,639
cat,yolov8n,18285977255_534ec8e749_z.jpg,427,640,3,1,0.420811832,415,461,97.18969555,72.03125,179,640,0,415
cat,yolov8n,9372235876_d7d69f1790_z.jpg,498,640,3,1,0.898605108,481,524,96.58634538,81.875,1,525,17,498
cat,yolov8n,7175939730_9a03853d4c_z.jpg,480,640,3,1,0.478906363,173,137,36.04166667,21.40625,232,369,117,290
cat,yolov8n,4991188769_8642331e2c_z.jpg,448,640,3,1,0.885644615,428,580,95.53571429,90.625,6,586,12,440
cat,yolov8n,20264405486_14055e8288_z.jpg,480,640,3,1,0.861501396,394,507,82.08333333,79.21875,112,619,63,457
cat,yolov8n,9002629162_51388d1396_z.jpg,427,640,3,1,0.924134791,421,597,98.59484778,93.28125,42,639,0,421
cat,yolov8n,15589191923_99889a9f83_z.jpg,640,480,3,1,0.879633129,637,423,99.53125,88.125,56,479,2,639
cat,yolov8n,7685782426_d3615820e9_z.jpg,427,640,3,1,0.915630579,417,581,97.65807963,90.78125,59,640,5,422
cat,yolov8n,5974549533_83d56b822d_z.jpg,424,640,3,1,0.7482844,412,624,97.16981132,97.5,2,626,1,413
cat,yolov8n,16278721974_968bd6bbcf_z.jpg,359,639,3,1,0.927375674,197,290,54.87465181,45.38341158,229,519,111,308
cat,yolov8n,3582713912_3d9ac5ecc9_z.jpg,480,640,3,1,0.591431797,436,514,90.83333333,80.3125,126,640,43,479
cat,yolov8n,3582713912_3d9ac5ecc9_z.jpg,480,640,3,1,0.340153873,474,601,98.75,93.90625,2,603,5,479
cat,yolov8n,2215395014_24a2f8184c_z.jpg,512,639,3,1,0.410962194,500,637,97.65625,99.68701095,1,638,4,504
cat,yolov8n,2215395014_24a2f8184c_z.jpg,512,639,3,1,0.333564222,312,525,60.9375,82.15962441,7,532,0,312
cat,yolov8n,8213118547_f274c67e93_z.jpg,427,640,3,1,0.91895467,381,374,89.22716628,58.4375,1,375,41,422
cat,yolov8n,2230295891_a68077f047_z.jpg,430,640,3,1,0.792849422,360,403,83.72093023,62.96875,0,403,69,429
cat,yolov8n,2230295891_a68077f047_z.jpg,430,640,3,1,0.349047661,311,271,72.3255814,42.34375,369,640,114,425
cat,yolov8n,2230295891_a68077f047_z.jpg,430,640,3,1,0.286579847,360,620,83.72093023,96.875,15,635,66,426
cat,yolov8n,15837810787_14c16de452_z.jpg,425,639,3,1,0.875975549,265,415,62.35294118,64.94522692,167,582,85,350
cat,yolov8n,3607850542_a3577913d7_z.jpg,480,640,3,1,0.837556481,478,636,99.58333333,99.375,1,637,1,479
cat,yolov8n,1492095547_3a48dbc70b_z.jpg,480,640,3,1,0.687547147,350,541,72.91666667,84.53125,99,640,130,480
cat,yolov8n,5549228224_a42f7d5300_z.jpg,425,640,3,0,0,0,0,0,0,0,0,0,0
cat,yolov8n,6455179889_6db5a93bfa_z.jpg,505,640,3,1,0.892114103,497,462,98.41584158,72.1875,1,463,3,500
cat,yolov8n,225687978_713319e6c1_z.jpg,640,427,3,1,0.441228688,634,422,99.0625,98.82903981,3,425,3,637
cat,yolov8n,3360078465_de3ceaa137_z.jpg,640,426,3,1,0.923024476,589,399,92.03125,93.66197183,6,405,48,637
cat,yolov8n,5436402112_3aee3141a7_z.jpg,518,640,3,1,0.868113279,455,296,87.83783784,46.25,111,407,59,514
cat,yolov8n,4730790029_bdc24fcb8c_z.jpg,428,639,3,1,0.811295748,420,463,98.13084112,72.45696401,115,578,1,421
cat,yolov8n,16599186017_25f46b7511_z.jpg,640,640,3,1,0.762651682,622,605,97.1875,94.53125,10,615,18,640
cat,yolov8n,2538610337_8cbdfed59e_z.jpg,640,590,3,1,0.835056126,610,580,95.3125,98.30508475,6,586,27,637
cat,yolov8n,2218544892_0ae9cb42da_z.jpg,480,640,3,1,0.865625262,479,458,99.79166667,71.5625,181,639,1,480
cat,yolov8n,219320127_ff9873aaf5_z.jpg,480,640,3,1,0.909584761,417,534,86.875,83.4375,0,534,57,474
cat,yolov8n,1110261834_4068e20626_z.jpg,480,640,3,1,0.655774117,468,534,97.5,83.4375,6,540,12,480
cat,yolov8n,15237426722_a51d199f2f_z.jpg,520,640,3,1,0.802497387,439,471,84.42307692,73.59375,135,606,65,504
cat,yolov8n,3372528428_1fdbd7e39c_z.jpg,640,480,3,1,0.916626751,636,480,99.375,100,0,480,3,639
cat,yolov8n,3703720579_4a2cf4af15_z.jpg,478,640,3,1,0.913163424,354,290,74.05857741,45.3125,5,295,70,424
cat,yolov8n,2206074222_69cc088500_z.jpg,426,640,3,1,0.850918293,384,640,90.14084507,100,0,640,39,423
cat,yolov8n,4226351112_a6f67d031e_z.jpg,480,640,3,1,0.898018897,466,378,97.08333333,59.0625,206,584,14,480
cat,yolov8n,17594682014_fcd2ac5ca3_z.jpg,480,640,3,1,0.633858681,440,623,91.66666667,97.34375,15,638,39,479
cat,yolov8n,4743123794_5c502eaee7_z.jpg,640,427,3,1,0.69748193,476,388,74.375,90.86651054,39,427,1,477
cat,yolov8n,6100259603_28a9794ed5_z.jpg,427,640,3,1,0.780098915,420,513,98.36065574,80.15625,126,639,2,422
cat,yolov8n,4781592393_07d35524ef_z.jpg,640,427,3,1,0.91250062,582,378,90.9375,88.52459016,48,426,56,638
cat,yolov8n,858829152_629399f0a4_z.jpg,640,480,3,1,0.827816963,498,412,77.8125,85.83333333,0,412,91,589
cat,yolov8n,2861862980_8aab1934f0_z.jpg,480,640,3,1,0.821356893,464,618,96.66666667,96.5625,9,627,16,480
cat,yolov8n,12988804124_bbea6d94c0_z.jpg,428,640,3,1,0.875533283,403,613,94.1588785,95.78125,14,627,18,421
cat,yolov8n,1980856023_6049619444_z.jpg,480,640,3,1,0.588177562,479,612,99.79166667,95.625,3,615,0,479
cat,yolov8n,33580840_a67c2b796a_z.jpg,480,640,3,1,0.936723053,477,463,99.375,72.34375,0,463,2,479
cat,yolov8n,14711690133_019fe56eb5_z.jpg,427,640,3,1,0.843547702,378,546,88.52459016,85.3125,93,639,2,380
cat,yolov8n,258460789_c4baeb300a_z.jpg,472,639,3,1,0.868502796,445,400,94.27966102,62.59780908,0,400,16,461
cat,yolov8n,9478594118_5861e54c87_z.jpg,480,640,3,1,0.71653372,320,636,66.66666667,99.375,2,638,1,321
cat,yolov8n,6924362656_d86bedc2e4_z.jpg,480,640,3,1,0.858129859,427,519,88.95833333,81.09375,48,567,0,427
cat,yolov8n,1570513225_265b529538_z.jpg,429,640,3,1,0.920901299,309,330,72.02797203,51.5625,205,535,115,424
cat,yolov8n,7664570690_6ab2f0ab5d_z.jpg,480,640,3,1,0.688771307,474,572,98.75,89.375,67,639,6,480
cat,yolov8n,7664570690_6ab2f0ab5d_z.jpg,480,640,3,1,0.262536496,476,226,99.16666667,35.3125,1,227,0,476
cat,yolov8n,9573099282_bbc0b12c70_z.jpg,487,640,3,1,0.874380946,483,561,99.17864476,87.65625,79,640,0,483
cat,yolov8n,2709706154_32ff27825a_z.jpg,480,640,3,1,0.363286972,478,619,99.58333333,96.71875,19,638,1,479
cat,yolov8n,2244176071_615b055c30_z.jpg,640,480,3,1,0.856429517,629,439,98.28125,91.45833333,35,474,8,637
cat,yolov8n,207320225_2446b6cf11_z.jpg,427,640,3,1,0.875700653,324,302,75.87822014,47.1875,235,537,92,416
cat,yolov8n,207320225_2446b6cf11_z.jpg,427,640,3,1,0.863155186,193,227,45.19906323,35.46875,136,363,92,285
cat,yolov8n,3069852951_85b984b709_z.jpg,474,639,3,1,0.856806874,462,635,97.46835443,99.37402191,1,636,1,463
cat,yolov8n,2999108747_2b1e0ac45f_z.jpg,640,480,3,1,0.880669236,511,340,79.84375,70.83333333,80,420,59,570
cat,yolov8n,80536950_5993089209_z.jpg,480,640,3,1,0.761795044,478,636,99.58333333,99.375,3,639,0,478
cat,yolov8n,438887381_0a2a4e97e4_z.jpg,640,428,3,1,0.87862277,599,417,93.59375,97.42990654,7,424,41,640
cat,yolov8n,1428837563_12ec867e05_z.jpg,480,640,3,1,0.760204911,397,335,82.70833333,52.34375,158,493,25,422
cat,yolov8n,422908475_7be8fe7338_z.jpg,640,567,3,1,0.87435323,584,524,91.25,92.41622575,0,524,56,640
cat,yolov8n,15584457029_80b75274db_z.jpg,427,640,3,1,0.928976238,300,230,70.25761124,35.9375,186,416,105,405
cat,yolov8n,449567850_48a3c60a6f_z.jpg,398,640,3,1,0.719860494,374,624,93.96984925,97.5,2,626,14,388
cat,yolov8n,11335325886_75cf456ea8_z.jpg,580,640,3,1,0.86335814,556,640,95.86206897,100,0,640,16,572
cat,yolov8n,5048937296_7c707f1d71_z.jpg,558,640,3,1,0.87033689,439,435,78.67383513,67.96875,190,625,63,502
cat,yolov8n,15617633365_316afedb8d_z.jpg,640,640,3,1,0.741844475,631,562,98.59375,87.8125,76,638,0,631
cat,yolov8n,6835338988_c013b40c94_z.jpg,441,640,3,1,0.934089243,385,527,87.3015873,82.34375,29,556,17,402
cat,yolov8n,412652687_4d6cb46129_z.jpg,640,463,3,1,0.837678611,466,456,72.8125,98.48812095,5,461,172,638
cat,yolov8n,6180200475_fda2795252_z.jpg,640,480,3,1,0.507185042,617,461,96.40625,96.04166667,0,461,23,640
cat,yolov8n,2553120516_dd48754dc4_z.jpg,424,640,3,1,0.542070568,384,423,90.56603774,66.09375,162,585,0,384
cat,yolov8n,8523144329_569f1781b3_z.jpg,519,640,3,1,0.499491006,510,599,98.26589595,93.59375,27,626,0,510
cat,yolov8n,8523144329_569f1781b3_z.jpg,519,640,3,1,0.476178497,506,359,97.49518304,56.09375,186,545,0,506
cat,yolov8n,31792151_e1e4c47427_z.jpg,423,640,3,1,0.810654342,328,608,77.54137116,95,24,632,89,417
cat,yolov8n,31792151_e1e4c47427_z.jpg,423,640,3,1,0.590251744,331,320,78.25059102,50,320,640,15,346
cat,yolov8n,12041194676_da91e0d068_z.jpg,427,640,3,1,0.904962242,375,474,87.82201405,74.0625,159,633,47,422
cat,yolov8n,2718097307_1fb900f17a_z.jpg,427,640,3,1,0.822776854,230,395,53.86416862,61.71875,192,587,92,322
cat,yolov8n,7019541657_00e6c7a645_z.jpg,419,640,3,1,0.913375139,366,367,87.35083532,57.34375,153,520,33,399
cat,yolov8n,2667833832_bf9ddddac5_z.jpg,640,480,3,1,0.923885107,597,390,93.28125,81.25,9,399,34,631
cat,yolov8n,6062750656_89284163db_z.jpg,426,640,3,1,0.781057596,110,96,25.82159624,15,468,564,220,330
cat,yolov8n,777472482_5eae8617bd_z.jpg,639,478,3,1,0.901744664,599,455,93.74021909,95.18828452,22,477,28,627
cat,yolov8n,3632975096_ec47d16f37_z.jpg,479,640,3,1,0.843485117,436,573,91.02296451,89.53125,65,638,0,436
cat,yolov8n,3844809782_aa1ce17781_z.jpg,480,640,3,1,0.701084256,476,597,99.16666667,93.28125,20,617,4,480
cat,yolov8n,3844809782_aa1ce17781_z.jpg,480,640,3,1,0.563629985,464,398,96.66666667,62.1875,26,424,14,478
cat,yolov8n,8464801471_b2b61acc7b_z.jpg,427,640,3,1,0.799428403,421,636,98.59484778,99.375,2,638,0,421
cat,yolov8n,8526465743_29a9320d16_z.jpg,612,612,3,1,0.811795533,610,455,99.67320261,74.34640523,74,529,2,612
cat,yolov8n,3283350420_d2b4b8fef3_z.jpg,427,640,3,1,0.894323349,390,622,91.33489461,97.1875,14,636,21,411
cat,yolov8n,3959888385_3580cd572c_z.jpg,639,494,3,1,0.776577711,456,478,71.36150235,96.7611336,2,480,60,516
cat,yolov8n,3895919953_9ba2530425_z.jpg,425,640,3,1,0.932759583,354,366,83.29411765,57.1875,1,367,67,421
cat,yolov8s,12570366253_52905ec5a1_z.jpg,476,640,3,1,0.813502073,454,452,95.37815126,70.625,41,493,15,469
cat,yolov8s,11101898274_dcf6061b20_z.jpg,427,640,3,1,0.913388848,385,441,90.16393443,68.90625,124,565,16,401
cat,yolov8s,2177230709_086e9d23d8_z.jpg,422,639,3,1,0.796798766,272,637,64.4549763,99.68701095,0,637,80,352
cat,yolov8s,3029397040_d35cf11083_z.jpg,428,639,3,1,0.875720322,368,635,85.98130841,99.37402191,1,636,56,424
cat,yolov8s,1240686712_fbccf26b7f_z.jpg,427,640,3,1,0.897347391,416,420,97.42388759,65.625,104,524,0,416
cat,yolov8s,138805025_80da2e3a82_z.jpg,480,640,3,1,0.885930181,333,614,69.375,95.9375,25,639,24,357
cat,yolov8s,15516450642_4fffe9be37_z.jpg,640,640,3,1,0.94627738,525,513,82.03125,80.15625,125,638,113,638
cat,yolov8s,18285977255_534ec8e749_z.jpg,427,640,3,1,0.580225885,419,458,98.1264637,71.5625,181,639,2,421
cat,yolov8s,9372235876_d7d69f1790_z.jpg,498,640,3,1,0.894798398,480,523,96.38554217,81.71875,0,523,12,492
cat,yolov8s,7175939730_9a03853d4c_z.jpg,480,640,3,1,0.36283198,173,128,36.04166667,20,232,360,115,288
cat,yolov8s,4991188769_8642331e2c_z.jpg,448,640,3,1,0.90188545,428,583,95.53571429,91.09375,8,591,16,444
cat,yolov8s,20264405486_14055e8288_z.jpg,480,640,3,1,0.872804999,399,523,83.125,81.71875,113,636,61,460
cat,yolov8s,9002629162_51388d1396_z.jpg,427,640,3,1,0.903434694,423,587,99.06323185,91.71875,53,640,0,423
cat,yolov8s,15589191923_99889a9f83_z.jpg,640,480,3,1,0.865790784,638,416,99.6875,86.66666667,63,479,1,639
cat,yolov8s,7685782426_d3615820e9_z.jpg,427,640,3,1,0.891101182,422,623,98.82903981,97.34375,16,639,0,422
cat,yolov8s,5974549533_83d56b822d_z.jpg,424,640,3,1,0.837721765,414,635,97.64150943,99.21875,0,635,0,414
cat,yolov8s,16278721974_968bd6bbcf_z.jpg,359,639,3,1,0.946014881,199,290,55.43175487,45.38341158,229,519,110,309
cat,yolov8s,3582713912_3d9ac5ecc9_z.jpg,480,640,3,1,0.831023574,429,512,89.375,80,127,639,51,480
cat,yolov8s,2215395014_24a2f8184c_z.jpg,512,639,3,1,0.675459683,500,637,97.65625,99.68701095,1,638,0,500
cat,yolov8s,2215395014_24a2f8184c_z.jpg,512,639,3,1,0.252299905,287,512,56.0546875,80.12519562,10,522,1,288
cat,yolov8s,8213118547_f274c67e93_z.jpg,427,640,3,1,0.940772951,383,374,89.69555035,58.4375,1,375,40,423
cat,yolov8s,2230295891_a68077f047_z.jpg,430,640,3,1,0.862391055,362,401,84.18604651,62.65625,1,402,64,426
cat,yolov8s,2230295891_a68077f047_z.jpg,430,640,3,1,0.662099004,307,291,71.39534884,45.46875,348,639,118,425
cat,yolov8s,15837810787_14c16de452_z.jpg,425,639,3,1,0.886361718,264,395,62.11764706,61.81533646,167,562,86,350
cat,yolov8s,3607850542_a3577913d7_z.jpg,480,640,3,1,0.842073321,478,633,99.58333333,98.90625,2,635,1,479
cat,yolov8s,1492095547_3a48dbc70b_z.jpg,480,640,3,1,0.883794665,351,541,73.125,84.53125,98,639,128,479
cat,yolov8s,5549228224_a42f7d5300_z.jpg,425,640,3,1,0.479175657,413,637,97.17647059,99.53125,2,639,2,415
cat,yolov8s,6455179889_6db5a93bfa_z.jpg,505,640,3,1,0.917255402,495,460,98.01980198,71.875,0,460,4,499
cat,yolov8s,225687978_713319e6c1_z.jpg,640,427,3,1,0.815417528,635,425,99.21875,99.53161593,2,427,1,636
cat,yolov8s,3360078465_de3ceaa137_z.jpg,640,426,3,1,0.924082756,604,397,94.375,93.19248826,4,401,36,640
cat,yolov8s,5436402112_3aee3141a7_z.jpg,518,640,3,1,0.932773054,465,294,89.76833977,45.9375,111,405,50,515
cat,yolov8s,4730790029_bdc24fcb8c_z.jpg,428,639,3,1,0.911087036,421,463,98.36448598,72.45696401,117,580,0,421
cat,yolov8s,16599186017_25f46b7511_z.jpg,640,640,3,1,0.913164258,619,606,96.71875,94.6875,32,638,17,636
cat,yolov8s,2538610337_8cbdfed59e_z.jpg,640,590,3,1,0.655875504,617,564,96.40625,95.59322034,4,568,22,639
cat,yolov8s,2218544892_0ae9cb42da_z.jpg,480,640,3,1,0.886064112,478,461,99.58333333,72.03125,178,639,2,480
cat,yolov8s,219320127_ff9873aaf5_z.jpg,480,640,3,1,0.928355694,414,531,86.25,82.96875,0,531,60,474
cat,yolov8s,1110261834_4068e20626_z.jpg,480,640,3,1,0.774810493,443,435,92.29166667,67.96875,73,508,36,479
cat,yolov8s,15237426722_a51d199f2f_z.jpg,520,640,3,1,0.905558348,429,470,82.5,73.4375,134,604,68,497
cat,yolov8s,3372528428_1fdbd7e39c_z.jpg,640,480,3,1,0.913450599,625,479,97.65625,99.79166667,0,479,12,637
cat,yolov8s,3703720579_4a2cf4af15_z.jpg,478,640,3,1,0.93999505,358,287,74.89539749,44.84375,7,294,68,426
cat,yolov8s,2206074222_69cc088500_z.jpg,426,640,3,1,0.894331157,381,626,89.43661972,97.8125,6,632,43,424
cat,yolov8s,4226351112_a6f67d031e_z.jpg,480,640,3,1,0.926029444,475,367,98.95833333,57.34375,218,585,4,479
cat,yolov8s,17594682014_fcd2ac5ca3_z.jpg,480,640,3,1,0.825900376,449,633,93.54166667,98.90625,6,639,4,453
cat,yolov8s,4743123794_5c502eaee7_z.jpg,640,427,3,1,0.553737104,631,380,98.59375,88.99297424,47,427,1,632
cat,yolov8s,4743123794_5c502eaee7_z.jpg,640,427,3,1,0.482304096,520,319,81.25,74.70725995,107,426,0,520
cat,yolov8s,6100259603_28a9794ed5_z.jpg,427,640,3,1,0.814265192,421,581,98.59484778,90.78125,59,640,1,422
cat,yolov8s,4781592393_07d35524ef_z.jpg,640,427,3,1,0.932268083,593,412,92.65625,96.48711944,14,426,46,639
cat,yolov8s,858829152_629399f0a4_z.jpg,640,480,3,1,0.860912383,482,414,75.3125,86.25,1,415,90,572
cat,yolov8s,2861862980_8aab1934f0_z.jpg,480,640,3,1,0.797491252,465,610,96.875,95.3125,12,622,15,480
cat,yolov8s,12988804124_bbea6d94c0_z.jpg,428,640,3,1,0.825042725,417,604,97.42990654,94.375,8,612,3,420
cat,yolov8s,1980856023_6049619444_z.jpg,480,640,3,1,0.678594708,478,562,99.58333333,87.8125,2,564,1,479
cat,yolov8s,33580840_a67c2b796a_z.jpg,480,640,3,1,0.918147802,474,461,98.75,72.03125,1,462,6,480
cat,yolov8s,14711690133_019fe56eb5_z.jpg,427,640,3,1,0.901466787,378,549,88.52459016,85.78125,89,638,0,378
cat,yolov8s,258460789_c4baeb300a_z.jpg,472,639,3,1,0.880174518,449,423,95.12711864,66.1971831,1,424,17,466
cat,yolov8s,9478594118_5861e54c87_z.jpg,480,640,3,1,0.852080643,315,638,65.625,99.6875,2,640,1,316
cat,yolov8s,6924362656_d86bedc2e4_z.jpg,480,640,3,1,0.868496418,422,503,87.91666667,78.59375,34,537,2,424
cat,yolov8s,1570513225_265b529538_z.jpg,429,640,3,1,0.868460178,305,451,71.0955711,70.46875,98,549,118,423
cat,yolov8s,7664570690_6ab2f0ab5d_z.jpg,480,640,3,1,0.898741722,479,572,99.79166667,89.375,68,640,1,480
cat,yolov8s,7664570690_6ab2f0ab5d_z.jpg,480,640,3,1,0.297042638,467,223,97.29166667,34.84375,1,224,1,468
cat,yolov8s,9573099282_bbc0b12c70_z.jpg,487,640,3,1,0.882353067,477,592,97.94661191,92.5,48,640,2,479
cat,yolov8s,2709706154_32ff27825a_z.jpg,480,640,3,1,0.661159635,479,635,99.79166667,99.21875,2,637,1,480
cat,yolov8s,2244176071_615b055c30_z.jpg,640,480,3,1,0.833173156,609,415,95.15625,86.45833333,55,470,24,633
cat,yolov8s,207320225_2446b6cf11_z.jpg,427,640,3,1,0.937237561,331,299,77.5175644,46.71875,238,537,91,422
cat,yolov8s,207320225_2446b6cf11_z.jpg,427,640,3,1,0.912675619,192,227,44.96487119,35.46875,136,363,96,288
cat,yolov8s,3069852951_85b984b709_z.jpg,474,639,3,1,0.884811521,469,638,98.94514768,99.84350548,1,639,1,470
cat,yolov8s,2999108747_2b1e0ac45f_z.jpg,640,480,3,1,0.855999649,513,331,80.15625,68.95833333,86,417,62,575
cat,yolov8s,80536950_5993089209_z.jpg,480,640,3,1,0.808406055,478,626,99.58333333,97.8125,11,637,1,479
cat,yolov8s,438887381_0a2a4e97e4_z.jpg,640,428,3,1,0.887105525,583,416,91.09375,97.19626168,0,416,54,637
cat,yolov8s,1428837563_12ec867e05_z.jpg,480,640,3,1,0.917117238,389,329,81.04166667,51.40625,162,491,35,424
cat,yolov8s,422908475_7be8fe7338_z.jpg,640,567,3,1,0.909889817,579,502,90.46875,88.5361552,0,502,59,638
cat,yolov8s,15584457029_80b75274db_z.jpg,427,640,3,1,0.948103666,298,230,69.78922717,35.9375,186,416,107,405
cat,yolov8s,449567850_48a3c60a6f_z.jpg,398,640,3,1,0.888409317,372,636,93.46733668,99.375,3,639,18,390
cat,yolov8s,11335325886_75cf456ea8_z.jpg,580,640,3,1,0.853463709,519,628,89.48275862,98.125,2,630,53,572
cat,yolov8s,5048937296_7c707f1d71_z.jpg,558,640,3,1,0.879914463,443,453,79.390681,70.78125,186,639,57,500
cat,yolov8s,15617633365_316afedb8d_z.jpg,640,640,3,1,0.875252604,631,509,98.59375,79.53125,129,638,1,632
cat,yolov8s,6835338988_c013b40c94_z.jpg,441,640,3,1,0.878309846,395,528,89.569161,82.5,29,557,21,416
cat,yolov8s,412652687_4d6cb46129_z.jpg,640,463,3,1,0.892820537,478,444,74.6875,95.89632829,18,462,161,639
cat,yolov8s,6180200475_fda2795252_z.jpg,640,480,3,1,0.830397666,619,448,96.71875,93.33333333,2,450,19,638
cat,yolov8s,2553120516_dd48754dc4_z.jpg,424,640,3,1,0.68908298,394,452,92.9245283,70.625,159,611,0,394
cat,yolov8s,8523144329_569f1781b3_z.jpg,519,640,3,1,0.823393285,508,503,97.8805395,78.59375,42,545,0,508
cat,yolov8s,31792151_e1e4c47427_z.jpg,423,640,3,1,0.875254691,322,309,76.12293144,48.28125,331,640,18,340
cat,yolov8s,31792151_e1e4c47427_z.jpg,423,640,3,1,0.873263359,327,610,77.30496454,95.3125,30,640,91,418
cat,yolov8s,12041194676_da91e0d068_z.jpg,427,640,3,1,0.882536769,371,459,86.8852459,71.71875,176,635,51,422
cat,yolov8s,2718097307_1fb900f17a_z.jpg,427,640,3,1,0.925076425,235,395,55.03512881,61.71875,190,585,95,330
cat,yolov8s,7019541657_00e6c7a645_z.jpg,419,640,3,1,0.926457047,368,367,87.82816229,57.34375,154,521,30,398
cat,yolov8s,2667833832_bf9ddddac5_z.jpg,640,480,3,1,0.911945462,594,390,92.8125,81.25,7,397,39,633
cat,yolov8s,6062750656_89284163db_z.jpg,426,640,3,1,0.788497567,108,101,25.35211268,15.78125,463,564,220,328
cat,yolov8s,6062750656_89284163db_z.jpg,426,640,3,1,0.457787156,83,83,19.48356808,12.96875,266,349,311,394
cat,yolov8s,777472482_5eae8617bd_z.jpg,639,478,3,1,0.876161456,622,453,97.33959311,94.76987448,25,478,13,635
cat,yolov8s,3632975096_ec47d16f37_z.jpg,479,640,3,1,0.847859979,436,588,91.02296451,91.875,52,640,0,436
cat,yolov8s,3844809782_aa1ce17781_z.jpg,480,640,3,1,0.756913304,450,614,93.75,95.9375,15,629,30,480
cat,yolov8s,3844809782_aa1ce17781_z.jpg,480,640,3,1,0.700752079,464,408,96.66666667,63.75,22,430,15,479
cat,yolov8s,8464801471_b2b61acc7b_z.jpg,427,640,3,1,0.912939072,424,635,99.29742389,99.21875,3,638,0,424
cat,yolov8s,8526465743_29a9320d16_z.jpg,612,612,3,1,0.830423772,609,400,99.50980392,65.35947712,110,510,2,611
cat,yolov8s,3283350420_d2b4b8fef3_z.jpg,427,640,3,1,0.892896116,388,619,90.86651054,96.71875,20,639,24,412
cat,yolov8s,3959888385_3580cd572c_z.jpg,639,494,3,1,0.853480756,445,482,69.6400626,97.5708502,0,482,70,515
cat,yolov8s,3895919953_9ba2530425_z.jpg,425,640,3,1,0.939218163,354,393,83.29411765,61.40625,1,394,66,420
cat,yolov8x,12570366253_52905ec5a1_z.jpg,476,640,3,1,0.725370526,450,392,94.53781513,61.25,42,434,20,470
cat,yolov8x,11101898274_dcf6061b20_z.jpg,427,640,3,1,0.965877235,388,434,90.86651054,67.8125,129,563,14,402
cat,yolov8x,11101898274_dcf6061b20_z.jpg,427,640,3,1,0.871773481,119,245,27.86885246,38.28125,283,528,265,384
cat,yolov8x,2177230709_086e9d23d8_z.jpg,422,639,3,1,0.959617972,323,639,76.54028436,100,0,639,63,386
cat,yolov8x,3029397040_d35cf11083_z.jpg,428,639,3,1,0.951129019,367,639,85.74766355,100,0,639,55,422
cat,yolov8x,1240686712_fbccf26b7f_z.jpg,427,640,3,1,0.852244198,387,421,90.6323185,65.78125,104,525,0,387
cat,yolov8x,138805025_80da2e3a82_z.jpg,480,640,3,1,0.940633595,333,595,69.375,92.96875,44,639,26,359
cat,yolov8x,15516450642_4fffe9be37_z.jpg,640,640,3,1,0.955292642,527,514,82.34375,80.3125,126,640,112,639
cat,yolov8x,18285977255_534ec8e749_z.jpg,427,640,3,1,0.909098744,419,460,98.1264637,71.875,179,639,1,420
cat,yolov8x,9372235876_d7d69f1790_z.jpg,498,640,3,1,0.964406252,479,523,96.18473896,81.71875,1,524,13,492
cat,yolov8x,7175939730_9a03853d4c_z.jpg,480,640,3,1,0.788765669,173,145,36.04166667,22.65625,216,361,116,289
cat,yolov8x,4991188769_8642331e2c_z.jpg,448,640,3,1,0.950983584,427,581,95.3125,90.78125,28,609,17,444
cat,yolov8x,20264405486_14055e8288_z.jpg,480,640,3,1,0.940727055,394,528,82.08333333,82.5,112,640,62,456
cat,yolov8x,9002629162_51388d1396_z.jpg,427,640,3,1,0.957117677,419,584,98.1264637,91.25,55,639,1,420
cat,yolov8x,15589191923_99889a9f83_z.jpg,640,480,3,1,0.928938866,638,406,99.6875,84.58333333,73,479,1,639
cat,yolov8x,7685782426_d3615820e9_z.jpg,427,640,3,1,0.955471754,419,622,98.1264637,97.1875,17,639,1,420
cat,yolov8x,5974549533_83d56b822d_z.jpg,424,640,3,1,0.874835968,388,565,91.50943396,88.28125,0,565,1,389
cat,yolov8x,16278721974_968bd6bbcf_z.jpg,359,639,3,1,0.960124969,199,291,55.43175487,45.5399061,228,519,110,309
cat,yolov8x,3582713912_3d9ac5ecc9_z.jpg,480,640,3,1,0.943508327,432,508,90,79.375,130,638,47,479
cat,yolov8x,2215395014_24a2f8184c_z.jpg,512,639,3,1,0.611613035,282,494,55.078125,77.30829421,32,526,0,282
cat,yolov8x,2215395014_24a2f8184c_z.jpg,512,639,3,1,0.343678504,503,637,98.2421875,99.68701095,1,638,1,504
cat,yolov8x,2215395014_24a2f8184c_z.jpg,512,639,3,1,0.261704683,272,638,53.125,99.84350548,0,638,232,504
cat,yolov8x,8213118547_f274c67e93_z.jpg,427,640,3,1,0.956375659,376,377,88.05620609,58.90625,1,378,44,420
cat,yolov8x,2230295891_a68077f047_z.jpg,430,640,3,1,0.956436515,358,398,83.25581395,62.1875,1,399,67,425
cat,yolov8x,2230295891_a68077f047_z.jpg,430,640,3,1,0.918580949,302,294,70.23255814,45.9375,346,640,120,422
cat,yolov8x,15837810787_14c16de452_z.jpg,425,639,3,1,0.938418448,261,395,61.41176471,61.81533646,169,564,87,348
cat,yolov8x,3607850542_a3577913d7_z.jpg,480,640,3,1,0.89547056,479,622,99.79166667,97.1875,1,623,1,480
cat,yolov8x,1492095547_3a48dbc70b_z.jpg,480,640,3,1,0.956410229,349,563,72.70833333,87.96875,77,640,130,479
cat,yolov8x,5549228224_a42f7d5300_z.jpg,425,640,3,1,0.809669793,416,637,97.88235294,99.53125,2,639,2,418
cat,yolov8x,6455179889_6db5a93bfa_z.jpg,505,640,3,1,0.905430377,495,522,98.01980198,81.5625,1,523,1,496
cat,yolov8x,225687978_713319e6c1_z.jpg,640,427,3,0,0,0,0,0,0,0,0,0,0
cat,yolov8x,3360078465_de3ceaa137_z.jpg,640,426,3,1,0.969495595,596,401,93.125,94.1314554,1,402,43,639
cat,yolov8x,5436402112_3aee3141a7_z.jpg,518,640,3,1,0.95641166,456,296,88.03088803,46.25,113,409,57,513
cat,yolov8x,4730790029_bdc24fcb8c_z.jpg,428,639,3,1,0.949831545,422,472,98.59813084,73.86541471,114,586,0,422
cat,yolov8x,16599186017_25f46b7511_z.jpg,640,640,3,1,0.926189244,633,637,98.90625,99.53125,1,638,3,636
cat,yolov8x,2538610337_8cbdfed59e_z.jpg,640,590,3,1,0.841499209,606,562,94.6875,95.25423729,1,563,33,639
cat,yolov8x,2218544892_0ae9cb42da_z.jpg,480,640,3,1,0.966320753,478,457,99.58333333,71.40625,182,639,0,478
cat,yolov8x,219320127_ff9873aaf5_z.jpg,480,640,3,1,0.967266262,423,532,88.125,83.125,1,533,53,476
cat,yolov8x,1110261834_4068e20626_z.jpg,480,640,3,1,0.920662463,433,388,90.20833333,60.625,116,504,46,479
cat,yolov8x,1110261834_4068e20626_z.jpg,480,640,3,1,0.592926681,477,629,99.375,98.28125,4,633,1,478
cat,yolov8x,15237426722_a51d199f2f_z.jpg,520,640,3,1,0.958909333,432,487,83.07692308,76.09375,131,618,65,497
cat,yolov8x,3372528428_1fdbd7e39c_z.jpg,640,480,3,1,0.965578377,636,478,99.375,99.58333333,1,479,2,638
cat,yolov8x,3703720579_4a2cf4af15_z.jpg,478,640,3,1,0.964620709,360,288,75.31380753,45,6,294,66,426
cat,yolov8x,2206074222_69cc088500_z.jpg,426,640,3,1,0.959234893,381,639,89.43661972,99.84375,0,639,38,419
cat,yolov8x,4226351112_a6f67d031e_z.jpg,480,640,3,1,0.946240783,471,374,98.125,58.4375,209,583,8,479
cat,yolov8x,17594682014_fcd2ac5ca3_z.jpg,480,640,3,1,0.955593646,414,638,86.25,99.6875,1,639,39,453
cat,yolov8x,4743123794_5c502eaee7_z.jpg,640,427,3,1,0.89729017,637,427,99.53125,100,0,427,1,638
cat,yolov8x,6100259603_28a9794ed5_z.jpg,427,640,3,1,0.940587699,401,561,93.91100703,87.65625,77,638,20,421
cat,yolov8x,4781592393_07d35524ef_z.jpg,640,427,3,1,0.94956404,576,418,90,97.89227166,7,425,63,639
cat,yolov8x,858829152_629399f0a4_z.jpg,640,480,3,1,0.936227024,497,411,77.65625,85.625,0,411,88,585
cat,yolov8x,2861862980_8aab1934f0_z.jpg,480,640,3,1,0.952142417,462,597,96.25,93.28125,23,620,17,479
cat,yolov8x,12988804124_bbea6d94c0_z.jpg,428,640,3,1,0.920250118,408,550,95.3271028,85.9375,90,640,8,416
cat,yolov8x,1980856023_6049619444_z.jpg,480,640,3,1,0.924251378,479,635,99.79166667,99.21875,2,637,0,479
cat,yolov8x,33580840_a67c2b796a_z.jpg,480,640,3,1,0.970907092,476,458,99.16666667,71.5625,1,459,3,479
cat,yolov8x,14711690133_019fe56eb5_z.jpg,427,640,3,1,0.955698669,405,543,94.84777518,84.84375,97,640,2,407
cat,yolov8x,258460789_c4baeb300a_z.jpg,472,639,3,1,0.91784215,445,427,94.27966102,66.82316119,0,427,19,464
cat,yolov8x,9478594118_5861e54c87_z.jpg,480,640,3,1,0.676020801,348,638,72.5,99.6875,1,639,3,351
cat,yolov8x,6924362656_d86bedc2e4_z.jpg,480,640,3,1,0.621863723,422,497,87.91666667,77.65625,35,532,2,424
cat,yolov8x,1570513225_265b529538_z.jpg,429,640,3,1,0.922365725,305,550,71.0955711,85.9375,21,571,118,423
cat,yolov8x,7664570690_6ab2f0ab5d_z.jpg,480,640,3,1,0.793142319,479,561,99.79166667,87.65625,78,639,0,479
cat,yolov8x,9573099282_bbc0b12c70_z.jpg,487,640,3,1,0.958764911,477,585,97.94661191,91.40625,55,640,3,480
cat,yolov8x,9573099282_bbc0b12c70_z.jpg,487,640,3,1,0.560657799,215,245,44.14784394,38.28125,395,640,1,216
cat,yolov8x,2709706154_32ff27825a_z.jpg,480,640,3,1,0.78864938,479,636,99.79166667,99.375,2,638,1,480
cat,yolov8x,2244176071_615b055c30_z.jpg,640,480,3,1,0.943040907,638,419,99.6875,87.29166667,53,472,1,639
cat,yolov8x,207320225_2446b6cf11_z.jpg,427,640,3,1,0.95590657,331,299,77.5175644,46.71875,238,537,91,422
cat,yolov8x,207320225_2446b6cf11_z.jpg,427,640,3,1,0.940880597,187,225,43.79391101,35.15625,137,362,99,286
cat,yolov8x,3069852951_85b984b709_z.jpg,474,639,3,1,0.931836247,465,637,98.10126582,99.68701095,1,638,1,466
cat,yolov8x,2999108747_2b1e0ac45f_z.jpg,640,480,3,1,0.943305552,505,345,78.90625,71.875,71,416,70,575
cat,yolov8x,80536950_5993089209_z.jpg,480,640,3,1,0.921539485,478,628,99.58333333,98.125,1,629,1,479
cat,yolov8x,438887381_0a2a4e97e4_z.jpg,640,428,3,1,0.965194881,590,420,92.1875,98.13084112,0,420,49,639
cat,yolov8x,1428837563_12ec867e05_z.jpg,480,640,3,1,0.941012204,388,328,80.83333333,51.25,164,492,35,423
cat,yolov8x,422908475_7be8fe7338_z.jpg,640,567,3,1,0.961312413,584,500,91.25,88.18342152,0,500,55,639
cat,yolov8x,15584457029_80b75274db_z.jpg,427,640,3,1,0.96007365,300,231,70.25761124,36.09375,186,417,105,405
cat,yolov8x,449567850_48a3c60a6f_z.jpg,398,640,3,1,0.959358335,373,638,93.71859296,99.6875,1,639,17,390
cat,yolov8x,11335325886_75cf456ea8_z.jpg,580,640,3,1,0.937627375,522,637,90,99.53125,1,638,51,573
cat,yolov8x,5048937296_7c707f1d71_z.jpg,558,640,3,1,0.946561515,433,454,77.59856631,70.9375,185,639,65,498
cat,yolov8x,15617633365_316afedb8d_z.jpg,640,640,3,1,0.893528581,633,515,98.90625,80.46875,122,637,1,634
cat,yolov8x,6835338988_c013b40c94_z.jpg,441,640,3,1,0.956287861,419,513,95.01133787,80.15625,40,553,17,436
cat,yolov8x,412652687_4d6cb46129_z.jpg,640,463,3,1,0.930182815,480,440,75,95.03239741,22,462,160,640
cat,yolov8x,6180200475_fda2795252_z.jpg,640,480,3,1,0.849310815,638,457,99.6875,95.20833333,1,458,1,639
cat,yolov8x,2553120516_dd48754dc4_z.jpg,424,640,3,1,0.689229667,386,482,91.03773585,75.3125,155,637,1,387
cat,yolov8x,8523144329_569f1781b3_z.jpg,519,640,3,1,0.953656197,511,509,98.45857418,79.53125,31,540,0,511
cat,yolov8x,31792151_e1e4c47427_z.jpg,423,640,3,1,0.924994767,326,606,77.06855792,94.6875,34,640,91,417
cat,yolov8x,31792151_e1e4c47427_z.jpg,423,640,3,1,0.918554902,330,308,78.0141844,48.125,331,639,13,343
cat,yolov8x,12041194676_da91e0d068_z.jpg,427,640,3,1,0.953425765,373,476,87.35362998,74.375,164,640,48,421
cat,yolov8x,2718097307_1fb900f17a_z.jpg,427,640,3,1,0.947315335,205,395,48.00936768,61.71875,189,584,93,298
cat,yolov8x,7019541657_00e6c7a645_z.jpg,419,640,3,1,0.889822364,366,439,87.35083532,68.59375,82,521,32,398
cat,yolov8x,2667833832_bf9ddddac5_z.jpg,640,480,3,1,0.964794993,593,388,92.65625,80.83333333,11,399,33,626
cat,yolov8x,6062750656_89284163db_z.jpg,426,640,3,1,0.822712302,109,102,25.58685446,15.9375,462,564,221,330
cat,yolov8x,6062750656_89284163db_z.jpg,426,640,3,1,0.702862382,85,89,19.95305164,13.90625,262,351,311,396
cat,yolov8x,6062750656_89284163db_z.jpg,426,640,3,1,0.425345093,93,82,21.83098592,12.8125,441,523,39,132
cat,yolov8x,777472482_5eae8617bd_z.jpg,639,478,3,1,0.963852942,621,444,97.18309859,92.88702929,27,471,1,622
cat,yolov8x,3632975096_ec47d16f37_z.jpg,479,640,3,1,0.944195032,437,586,91.23173278,91.5625,53,639,0,437
cat,yolov8x,3844809782_aa1ce17781_z.jpg,480,640,3,1,0.786512375,430,315,89.58333333,49.21875,322,637,50,480
cat,yolov8x,3844809782_aa1ce17781_z.jpg,480,640,3,1,0.681410491,462,436,96.25,68.125,0,436,17,479
cat,yolov8x,3844809782_aa1ce17781_z.jpg,480,640,3,1,0.650361896,360,395,75,61.71875,27,422,9,369
cat,yolov8x,3844809782_aa1ce17781_z.jpg,480,640,3,1,0.358426183,298,435,62.08333333,67.96875,0,435,182,480
cat,yolov8x,8464801471_b2b61acc7b_z.jpg,427,640,3,1,0.930453241,420,625,98.36065574,97.65625,1,626,1,421
cat,yolov8x,8526465743_29a9320d16_z.jpg,612,612,3,1,0.934401691,608,447,99.34640523,73.03921569,62,509,3,611
cat,yolov8x,3283350420_d2b4b8fef3_z.jpg,427,640,3,1,0.951871157,389,615,91.10070258,96.09375,24,639,30,419
cat,yolov8x,3959888385_3580cd572c_z.jpg,639,494,3,1,0.892673969,438,472,68.54460094,95.5465587,14,486,75,513
cat,yolov8x,3895919953_9ba2530425_z.jpg,425,640,3,1,0.952663958,354,393,83.29411765,61.40625,1,394,66,420
dog,yolov8l,7270802858_c6e2b115e4_z.jpg,640,640,3,1,0.952549815,297,382,46.40625,59.6875,116,498,239,536
dog,yolov8l,5753318048_1cde42cb1f_z.jpg,512,640,3,1,0.971029043,505,502,98.6328125,78.4375,1,503,6,511
dog,yolov8l,890847666_ec8eaecf88_z.jpg,640,480,3,1,0.971612155,370,258,57.8125,53.75,0,258,269,639
dog,yolov8l,809525484_e2e6f137aa_z.jpg,480,640,3,1,0.951448441,368,538,76.66666667,84.0625,58,596,111,479
dog,yolov8l,2169952827_05bddc305e_z.jpg,427,640,3,1,0.962594628,386,555,90.39812646,86.71875,84,639,36,422
dog,yolov8l,20959877010_552298f5f8_z.jpg,367,640,3,1,0.955204964,319,298,86.92098093,46.5625,20,318,6,325
dog,yolov8l,20959877010_552298f5f8_z.jpg,367,640,3,1,0.938570797,280,338,76.29427793,52.8125,300,638,73,353
dog,yolov8l,3290610375_c742148226_z.jpg,428,639,3,1,0.931520939,355,388,82.94392523,60.7198748,11,399,67,422
dog,yolov8l,2433596596_377bb91619_z.jpg,491,640,3,1,0.877641678,177,134,36.04887984,20.9375,506,640,28,205
dog,yolov8l,6113997729_5f5ac02209_z.jpg,480,640,3,1,0.943879128,338,316,70.41666667,49.375,168,484,58,396
dog,yolov8l,2277306387_af18b2096e_z.jpg,483,640,3,1,0.953563094,444,437,91.92546584,68.28125,143,580,1,445
dog,yolov8l,81717243_2c9fcf3dab_z.jpg,508,640,3,1,0.964686275,337,287,66.33858268,44.84375,208,495,127,464
dog,yolov8l,8343384446_ebe3bc86ce_z.jpg,640,617,3,1,0.95874542,526,297,82.1875,48.13614263,143,440,71,597
dog,yolov8l,2167290248_1ac3cbd890_z.jpg,639,485,3,1,0.951825857,594,420,92.95774648,86.59793814,4,424,44,638
dog,yolov8l,915541987_2627e91a14_z.jpg,640,431,3,1,0.966381311,507,431,79.21875,100,0,431,132,639
dog,yolov8l,5878631770_0c5592a1ee_z.jpg,427,640,3,1,0.937927961,320,536,74.94145199,83.75,103,639,101,421
dog,yolov8l,3209962531_f75dbe4341_z.jpg,445,639,3,1,0.964783669,390,518,87.64044944,81.06416275,121,639,49,439
dog,yolov8l,16107639462_07e2d4455d_z.jpg,427,640,3,1,0.958458066,373,423,87.35362998,66.09375,127,550,47,420
dog,yolov8l,3291298501_9a8eed3fa0_z.jpg,427,640,3,1,0.966106057,364,500,85.24590164,78.125,0,500,58,422
dog,yolov8l,34095624_ce7c705614_z.jpg,480,640,3,1,0.96763593,448,625,93.33333333,97.65625,14,639,31,479
dog,yolov8l,4122228889_3b69997e0c_z.jpg,640,478,3,1,0.939651787,371,301,57.96875,62.9707113,82,383,151,522
dog,yolov8l,6897439523_236f77f06f_z.jpg,452,640,3,1,0.961987972,321,329,71.01769912,51.40625,49,378,38,359
dog,yolov8l,6897439523_236f77f06f_z.jpg,452,640,3,1,0.865822136,328,306,72.56637168,47.8125,309,615,107,435
dog,yolov8l,6897439523_236f77f06f_z.jpg,452,640,3,1,0.731651545,290,145,64.15929204,22.65625,285,430,43,333
dog,yolov8l,7248771448_66aab6455d_z.jpg,495,640,3,1,0.973524451,423,457,85.45454545,71.40625,59,516,35,458
dog,yolov8l,6238072987_89f2925563_z.jpg,640,480,3,1,0.973800182,562,395,87.8125,82.29166667,84,479,77,639
dog,yolov8l,84410494_ab268290cf_z.jpg,480,640,3,1,0.970795035,480,405,100,63.28125,150,555,0,480
dog,yolov8l,19030996840_1fbbb14eeb_z.jpg,640,640,3,1,0.962556839,385,403,60.15625,62.96875,1,404,255,640
dog,yolov8l,19030996840_1fbbb14eeb_z.jpg,640,640,3,1,0.931999505,540,495,84.375,77.34375,90,585,5,545
dog,yolov8l,5093076088_7bc77ec199_z.jpg,480,640,3,1,0.956528962,193,226,40.20833333,35.3125,119,345,135,328
dog,yolov8l,5093076088_7bc77ec199_z.jpg,480,640,3,1,0.941773176,159,150,33.125,23.4375,334,484,234,393
dog,yolov8l,387284206_360c4e3d6e_z.jpg,313,639,3,1,0.933781981,256,258,81.78913738,40.37558685,0,258,31,287
dog,yolov8l,387284206_360c4e3d6e_z.jpg,313,639,3,1,0.820159614,229,249,73.1629393,38.96713615,136,385,80,309
dog,yolov8l,387284206_360c4e3d6e_z.jpg,313,639,3,1,0.581695676,290,349,92.65175719,54.61658842,289,638,12,302
dog,yolov8l,387284206_360c4e3d6e_z.jpg,313,639,3,1,0.259220362,297,525,94.88817891,82.15962441,113,638,11,308
dog,yolov8l,677743874_168dcb5ed1_z.jpg,427,640,3,1,0.94419831,230,213,53.86416862,33.28125,295,508,78,308
dog,yolov8l,677743874_168dcb5ed1_z.jpg,427,640,3,1,0.828767955,43,103,10.07025761,16.09375,297,400,53,96
dog,yolov8l,3968015804_ac83717a19_z.jpg,427,640,3,1,0.969444692,375,390,87.82201405,60.9375,123,513,46,421
dog,yolov8l,9031823026_3e55960d76_z.jpg,384,640,3,1,0.948121011,277,470,72.13541667,73.4375,110,580,83,360
dog,yolov8l,7928462126_bb6f3a98bf_z.jpg,427,640,3,1,0.952818692,420,420,98.36065574,65.625,56,476,0,420
dog,yolov8l,19309035192_8666b8c4e2_z.jpg,480,640,3,1,0.968595207,333,553,69.375,86.40625,0,553,109,442
dog,yolov8l,14584923986_debd346d81_z.jpg,640,640,3,1,0.934808195,640,639,100,99.84375,0,639,0,640
dog,yolov8l,5827517048_a890acd7e6_z.jpg,424,640,3,1,0.967505813,265,283,62.5,44.21875,357,640,131,396
dog,yolov8l,5827517048_a890acd7e6_z.jpg,424,640,3,1,0.737075031,141,205,33.25471698,32.03125,305,510,79,220
dog,yolov8l,3850147043_06970bc680_z.jpg,480,640,3,1,0.939622104,240,429,50,67.03125,77,506,45,285
dog,yolov8l,506974894_b74672813b_z.jpg,427,640,3,1,0.942047417,289,468,67.68149883,73.125,1,469,78,367
dog,yolov8l,506974894_b74672813b_z.jpg,427,640,3,1,0.648659348,111,363,25.99531616,56.71875,185,548,0,111
dog,yolov8l,4941417139_1608ab2596_z.jpg,480,640,3,1,0.927272439,386,617,80.41666667,96.40625,1,618,90,476
dog,yolov8l,361146297_ca9b5c8799_z.jpg,640,480,3,1,0.650653362,552,477,86.25,99.375,2,479,87,639
dog,yolov8l,19283436_772222a19e_z.jpg,472,640,3,1,0.894387424,367,204,77.75423729,31.875,214,418,101,468
dog,yolov8l,5589760101_cf3ec6080e_z.jpg,424,640,3,1,0.954994559,417,474,98.3490566,74.0625,88,562,0,417
dog,yolov8l,20646999908_c3400d3ef6_z.jpg,480,640,3,1,0.927901149,434,621,90.41666667,97.03125,1,622,46,480
dog,yolov8l,7443993440_80892cc39d_z.jpg,620,640,3,1,0.962164044,397,428,64.03225806,66.875,102,530,120,517
dog,yolov8l,3812603979_2102c37672_z.jpg,426,640,3,1,0.964893103,396,525,92.95774648,82.03125,99,624,27,423
dog,yolov8l,11709285374_bbb0e09e4e_z.jpg,477,640,3,1,0.961442709,383,424,80.29350105,66.25,0,424,89,472
dog,yolov8l,11709285374_bbb0e09e4e_z.jpg,477,640,3,1,0.649064064,151,102,31.65618449,15.9375,0,102,22,173
dog,yolov8l,2698863450_3a10857081_z.jpg,590,639,3,1,0.953639209,559,574,94.74576271,89.82785603,64,638,25,584
dog,yolov8l,241832541_43848dabf3_z.jpg,639,426,3,1,0.973724365,638,414,99.84350548,97.18309859,0,414,0,638
dog,yolov8l,14869105327_a74f23fa8a_z.jpg,600,639,3,1,0.956908882,527,385,87.83333333,60.25039124,95,480,0,527
dog,yolov8l,2814480856_385049d567_z.jpg,480,640,3,1,0.923989117,380,395,79.16666667,61.71875,148,543,0,380
dog,yolov8l,8132134109_24eaa95e21_z.jpg,359,639,3,1,0.93772161,347,325,96.65738162,50.86071987,147,472,0,347
dog,yolov8l,7283869010_60b2e311b5_z.jpg,587,639,3,1,0.96325475,326,364,55.53662692,56.96400626,155,519,190,516
dog,yolov8l,7283869010_60b2e311b5_z.jpg,587,639,3,1,0.746981025,87,104,14.82112436,16.27543036,438,542,261,348
dog,yolov8l,4163439575_7c6a260e8e_z.jpg,521,640,3,1,0.956761003,484,412,92.89827255,64.375,50,462,25,509
dog,yolov8l,5290576324_881daf8265_z.jpg,480,640,3,1,0.911388457,241,174,50.20833333,27.1875,104,278,166,407
dog,yolov8l,5290576324_881daf8265_z.jpg,480,640,3,1,0.897125006,176,124,36.66666667,19.375,374,498,42,218
dog,yolov8l,13472183804_b6c8633f6e_z.jpg,500,640,3,1,0.88162756,271,273,54.2,42.65625,232,505,147,418
dog,yolov8l,2296897953_08627d83a0_z.jpg,640,480,3,1,0.955919325,637,424,99.53125,88.33333333,0,424,2,639
dog,yolov8l,14351072751_334621d203_z.jpg,480,640,3,1,0.94963938,245,264,51.04166667,41.25,164,428,46,291
dog,yolov8l,14351072751_334621d203_z.jpg,480,640,3,1,0.906849384,139,435,28.95833333,67.96875,155,590,245,384
dog,yolov8l,9159634981_ea2947ff02_z.jpg,640,480,3,1,0.944608152,545,450,85.15625,93.75,1,451,95,640
dog,yolov8l,9132297449_f27a6b1a45_z.jpg,612,612,3,1,0.965734005,519,389,84.80392157,63.5620915,84,473,27,546
dog,yolov8l,11381011104_36225e2ccc_z.jpg,543,640,3,1,0.918639004,509,634,93.73848987,99.0625,5,639,28,537
dog,yolov8l,11381011104_36225e2ccc_z.jpg,543,640,3,1,0.400606126,273,249,50.27624309,38.90625,391,640,268,541
dog,yolov8l,239427670_897dedb1ea_z.jpg,425,640,3,1,0.932166994,417,528,98.11764706,82.5,1,529,2,419
dog,yolov8l,239427670_897dedb1ea_z.jpg,425,640,3,1,0.329987139,354,194,83.29411765,30.3125,446,640,52,406
dog,yolov8l,4231227841_3821544fe1_z.jpg,608,640,3,1,0.915456295,439,229,72.20394737,35.78125,205,434,158,597
dog,yolov8l,3462334590_2b8f39c540_z.jpg,548,639,3,1,0.933622956,123,116,22.44525547,18.15336463,328,444,344,467
dog,yolov8l,9201197273_a98cb719f5_z.jpg,480,640,3,1,0.973396003,479,397,99.79166667,62.03125,0,397,0,479
dog,yolov8l,5381237016_f49e86b880_z.jpg,383,640,3,1,0.958413839,291,271,75.97911227,42.34375,0,271,34,325
dog,yolov8l,2040136228_41c284c2cb_z.jpg,640,494,3,1,0.969979644,404,308,63.125,62.34817814,68,376,83,487
dog,yolov8l,4444608672_0fa9174b62_z.jpg,427,640,3,1,0.520697892,421,525,98.59484778,82.03125,0,525,0,421
dog,yolov8l,36110689_9cbbccb36a_z.jpg,496,640,3,1,0.912780404,473,587,95.36290323,91.71875,47,634,5,478
dog,yolov8l,13073061203_f7d640a8b3_z.jpg,428,639,3,1,0.926866293,199,379,46.4953271,59.3114241,1,380,85,284
dog,yolov8l,8730902798_bfe9360f4e_z.jpg,480,640,3,1,0.972423911,478,415,99.58333333,64.84375,224,639,1,479
dog,yolov8l,489195247_b908298ee6_z.jpg,480,640,3,1,0.944615841,418,296,87.08333333,46.25,194,490,61,479
dog,yolov8l,4018061968_3e03b2e96f_z.jpg,480,640,3,1,0.92954582,370,214,77.08333333,33.4375,224,438,50,420
dog,yolov8l,235979174_fcd7ef1374_z.jpg,640,480,3,1,0.956358552,534,302,83.4375,62.91666667,108,410,84,618
dog,yolov8l,15782459318_437c57f515_z.jpg,427,640,3,1,0.961247385,264,163,61.82669789,25.46875,120,283,160,424
dog,yolov8l,15782459318_437c57f515_z.jpg,427,640,3,1,0.96059078,242,166,56.67447307,25.9375,367,533,181,423
dog,yolov8l,4975505027_db5864977d_z.jpg,480,640,3,1,0.941465378,254,171,52.91666667,26.71875,414,585,106,360
dog,yolov8l,4975505027_db5864977d_z.jpg,480,640,3,1,0.895513952,134,199,27.91666667,31.09375,28,227,242,376
dog,yolov8l,4975505027_db5864977d_z.jpg,480,640,3,1,0.894485474,139,149,28.95833333,23.28125,335,484,224,363
dog,yolov8l,4975505027_db5864977d_z.jpg,480,640,3,1,0.878639698,136,139,28.33333333,21.71875,224,363,239,375
dog,yolov8l,4975505027_db5864977d_z.jpg,480,640,3,1,0.792372644,193,136,40.20833333,21.25,128,264,119,312
dog,yolov8l,4414731678_5f70c9f88e_z.jpg,480,640,3,1,0.762297392,286,416,59.58333333,65,137,553,85,371
dog,yolov8l,1570552254_fcac0be216_z.jpg,428,640,3,1,0.872898042,129,120,30.14018692,18.75,450,570,95,224
dog,yolov8l,1570552254_fcac0be216_z.jpg,428,640,3,1,0.849670231,141,128,32.94392523,20,128,256,81,222
dog,yolov8l,1570552254_fcac0be216_z.jpg,428,640,3,1,0.810210288,111,124,25.93457944,19.375,456,580,316,427
dog,yolov8l,7492624590_e473685314_z.jpg,626,640,3,1,0.92330569,572,529,91.37380192,82.65625,58,587,41,613
dog,yolov8l,5652496789_70e6f301e9_z.jpg,427,640,3,0,0,0,0,0,0,0,0,0,0
dog,yolov8l,104222040_c20f16bbc0_z.jpg,480,640,3,1,0.70407182,391,430,81.45833333,67.1875,51,481,88,479
dog,yolov8l,204668081_9bb000df17_z.jpg,550,640,3,1,0.967344224,374,384,68,60,1,385,60,434
dog,yolov8l,7475018518_6c715a96c1_z.jpg,427,640,3,1,0.961203218,293,459,68.61826698,71.71875,53,512,75,368
dog,yolov8l,20843800936_edcdd89338_z.jpg,533,640,3,1,0.96497345,430,438,80.67542214,68.4375,100,538,71,501
dog,yolov8l,319365750_c6ecd7afbc_z.jpg,480,640,3,1,0.953095257,334,375,69.58333333,58.59375,190,565,55,389
dog,yolov8l,2177634493_51ca0597e2_z.jpg,640,640,3,1,0.908738256,629,638,98.28125,99.6875,0,638,8,637
dog,yolov8l,8591221048_8fe555a40c_z.jpg,427,640,3,1,0.951077044,383,375,89.69555035,58.59375,129,504,25,408
dog,yolov8l,2787764752_0277f5bbb2_z.jpg,480,640,3,1,0.948889256,308,471,64.16666667,73.59375,81,552,111,419
dog,yolov8l,2592416858_f849d2ac8f_z.jpg,480,640,3,1,0.947796047,275,182,57.29166667,28.4375,9,191,204,479
dog,yolov8l,2592416858_f849d2ac8f_z.jpg,480,640,3,1,0.940720916,442,286,92.08333333,44.6875,302,588,37,479
dog,yolov8l,2592416858_f849d2ac8f_z.jpg,480,640,3,1,0.934937,345,170,71.875,26.5625,167,337,135,480
dog,yolov8l,3197300261_4e5e9c5e3e_z.jpg,640,640,3,1,0.942555785,535,413,83.59375,64.53125,140,553,56,591
dog,yolov8l,16086668084_0d1665cda4_z.jpg,640,554,3,1,0.96526581,559,490,87.34375,88.44765343,4,494,81,640
dog,yolov8l,14409775264_5b589b56b4_z.jpg,480,640,3,1,0.962642014,417,393,86.875,61.40625,31,424,57,474
dog,yolov8l,4467873253_2ce7540d62_z.jpg,427,640,3,1,0.922513187,409,526,95.78454333,82.1875,31,557,12,421
dog,yolov8l,105398161_799ded9b2a_z.jpg,640,480,3,1,0.918454409,446,399,69.6875,83.125,74,473,96,542
dog,yolov8l,252889263_3cf2d57f34_z.jpg,480,640,3,1,0.944176853,416,247,86.66666667,38.59375,216,463,54,470
dog,yolov8l,252889263_3cf2d57f34_z.jpg,480,640,3,1,0.657803178,198,133,41.25,20.78125,0,133,282,480
dog,yolov8l,1134141407_0254c76c4d_z.jpg,384,640,3,1,0.953795314,342,352,89.0625,55,83,435,42,384
dog,yolov8l,3676100181_dc21ca177f_z.jpg,640,480,3,1,0.935758471,134,139,20.9375,28.95833333,121,260,387,521
dog,yolov8m,7270802858_c6e2b115e4_z.jpg,640,640,3,1,0.972286046,296,382,46.25,59.6875,115,497,239,535
dog,yolov8m,5753318048_1cde42cb1f_z.jpg,512,640,3,1,0.973084927,505,501,98.6328125,78.28125,2,503,6,511
dog,yolov8m,890847666_ec8eaecf88_z.jpg,640,480,3,1,0.948875427,370,259,57.8125,53.95833333,1,260,269,639
dog,yolov8m,809525484_e2e6f137aa_z.jpg,480,640,3,1,0.950755417,369,535,76.875,83.59375,59,594,111,480
dog,yolov8m,2169952827_05bddc305e_z.jpg,427,640,3,1,0.953515172,387,554,90.6323185,86.5625,85,639,35,422
dog,yolov8m,20959877010_552298f5f8_z.jpg,367,640,3,1,0.942762256,321,299,87.46594005,46.71875,20,319,5,326
dog,yolov8m,20959877010_552298f5f8_z.jpg,367,640,3,1,0.745530725,272,331,74.11444142,51.71875,303,634,81,353
dog,yolov8m,3290610375_c742148226_z.jpg,428,639,3,1,0.910730481,354,381,82.71028037,59.62441315,18,399,67,421
dog,yolov8m,2433596596_377bb91619_z.jpg,491,640,3,1,0.846608043,172,134,35.0305499,20.9375,506,640,29,201
dog,yolov8m,2433596596_377bb91619_z.jpg,491,640,3,1,0.375779688,363,462,73.93075356,72.1875,65,527,123,486
dog,yolov8m,6113997729_5f5ac02209_z.jpg,480,640,3,1,0.944099247,338,317,70.41666667,49.53125,168,485,58,396
dog,yolov8m,2277306387_af18b2096e_z.jpg,483,640,3,1,0.946860015,442,440,91.51138716,68.75,143,583,3,445
dog,yolov8m,81717243_2c9fcf3dab_z.jpg,508,640,3,1,0.962856472,339,288,66.73228346,45,207,495,127,466
dog,yolov8m,8343384446_ebe3bc86ce_z.jpg,640,617,3,1,0.950372994,524,297,81.875,48.13614263,144,441,70,594
dog,yolov8m,2167290248_1ac3cbd890_z.jpg,639,485,3,1,0.931621432,594,418,92.95774648,86.18556701,5,423,44,638
dog,yolov8m,915541987_2627e91a14_z.jpg,640,431,3,1,0.943252325,506,430,79.0625,99.76798144,0,430,132,638
dog,yolov8m,5878631770_0c5592a1ee_z.jpg,427,640,3,1,0.953608751,324,535,75.87822014,83.59375,104,639,99,423
dog,yolov8m,3209962531_f75dbe4341_z.jpg,445,639,3,1,0.952947676,386,515,86.74157303,80.59467919,123,638,51,437
dog,yolov8m,16107639462_07e2d4455d_z.jpg,427,640,3,1,0.904854834,374,415,87.58782201,64.84375,127,542,47,421
dog,yolov8m,3291298501_9a8eed3fa0_z.jpg,427,640,3,1,0.953403533,364,494,85.24590164,77.1875,1,495,58,422
dog,yolov8m,34095624_ce7c705614_z.jpg,480,640,3,1,0.923947096,449,618,93.54166667,96.5625,22,640,30,479
dog,yolov8m,4122228889_3b69997e0c_z.jpg,640,478,3,1,0.947251916,371,301,57.96875,62.9707113,82,383,151,522
dog,yolov8m,6897439523_236f77f06f_z.jpg,452,640,3,1,0.951620162,321,328,71.01769912,51.25,49,377,39,360
dog,yolov8m,6897439523_236f77f06f_z.jpg,452,640,3,1,0.887971282,330,218,73.00884956,34.0625,398,616,107,437
dog,yolov8m,6897439523_236f77f06f_z.jpg,452,640,3,1,0.748574793,299,168,66.15044248,26.25,262,430,39,338
dog,yolov8m,7248771448_66aab6455d_z.jpg,495,640,3,1,0.941241443,426,464,86.06060606,72.5,57,521,32,458
dog,yolov8m,6238072987_89f2925563_z.jpg,640,480,3,1,0.93859446,559,397,87.34375,82.70833333,82,479,79,638
dog,yolov8m,84410494_ab268290cf_z.jpg,480,640,3,1,0.908551693,478,408,99.58333333,63.75,148,556,1,479
dog,yolov8m,19030996840_1fbbb14eeb_z.jpg,640,640,3,1,0.969286084,384,404,60,63.125,1,405,255,639
dog,yolov8m,19030996840_1fbbb14eeb_z.jpg,640,640,3,1,0.923817575,522,496,81.5625,77.5,88,584,25,547
dog,yolov8m,5093076088_7bc77ec199_z.jpg,480,640,3,1,0.94319582,159,150,33.125,23.4375,334,484,234,393
dog,yolov8m,5093076088_7bc77ec199_z.jpg,480,640,3,1,0.940065205,194,225,40.41666667,35.15625,121,346,134,328
dog,yolov8m,5093076088_7bc77ec199_z.jpg,480,640,3,1,0.80034399,85,73,17.70833333,11.40625,0,73,128,213
dog,yolov8m,387284206_360c4e3d6e_z.jpg,313,639,3,1,0.912158608,296,506,94.5686901,79.18622848,131,637,12,308
dog,yolov8m,387284206_360c4e3d6e_z.jpg,313,639,3,1,0.405374199,256,251,81.78913738,39.2801252,0,251,32,288
dog,yolov8m,387284206_360c4e3d6e_z.jpg,313,639,3,1,0.385866344,197,245,62.93929712,38.34115806,394,639,102,299
dog,yolov8m,677743874_168dcb5ed1_z.jpg,427,640,3,1,0.746393919,267,233,62.529274,36.40625,294,527,42,309
dog,yolov8m,677743874_168dcb5ed1_z.jpg,427,640,3,1,0.742027044,44,105,10.30444965,16.40625,296,401,53,97
dog,yolov8m,3968015804_ac83717a19_z.jpg,427,640,3,1,0.929395258,376,387,88.05620609,60.46875,125,512,47,423
dog,yolov8m,9031823026_3e55960d76_z.jpg,384,640,3,1,0.94410032,278,468,72.39583333,73.125,111,579,83,361
dog,yolov8m,7928462126_bb6f3a98bf_z.jpg,427,640,3,1,0.946699619,420,419,98.36065574,65.46875,56,475,0,420
dog,yolov8m,19309035192_8666b8c4e2_z.jpg,480,640,3,1,0.966417909,332,551,69.16666667,86.09375,1,552,110,442
dog,yolov8m,14584923986_debd346d81_z.jpg,640,640,3,1,0.807433069,637,637,99.53125,99.53125,2,639,1,638
dog,yolov8m,5827517048_a890acd7e6_z.jpg,424,640,3,1,0.956649423,265,282,62.5,44.0625,357,639,131,396
dog,yolov8m,5827517048_a890acd7e6_z.jpg,424,640,3,1,0.688150108,140,203,33.01886792,31.71875,306,509,81,221
dog,yolov8m,3850147043_06970bc680_z.jpg,480,640,3,1,0.941304028,239,430,49.79166667,67.1875,77,507,46,285
dog,yolov8m,506974894_b74672813b_z.jpg,427,640,3,1,0.938414037,287,469,67.21311475,73.28125,0,469,79,366
dog,yolov8m,506974894_b74672813b_z.jpg,427,640,3,1,0.719398439,112,370,26.2295082,57.8125,177,547,0,112
dog,yolov8m,4941417139_1608ab2596_z.jpg,480,640,3,1,0.914638937,424,628,88.33333333,98.125,2,630,51,475
dog,yolov8m,361146297_ca9b5c8799_z.jpg,640,480,3,1,0.811022162,552,475,86.25,98.95833333,4,479,87,639
dog,yolov8m,19283436_772222a19e_z.jpg,472,640,3,1,0.626535892,369,423,78.1779661,66.09375,212,635,98,467
dog,yolov8m,19283436_772222a19e_z.jpg,472,640,3,1,0.311821014,367,229,77.75423729,35.78125,213,442,100,467
dog,yolov8m,5589760101_cf3ec6080e_z.jpg,424,640,3,1,0.94989872,417,473,98.3490566,73.90625,91,564,1,418
dog,yolov8m,20646999908_c3400d3ef6_z.jpg,480,640,3,1,0.946678042,433,570,90.20833333,89.0625,51,621,46,479
dog,yolov8m,7443993440_80892cc39d_z.jpg,620,640,3,1,0.946927488,397,431,64.03225806,67.34375,101,532,121,518
dog,yolov8m,3812603979_2102c37672_z.jpg,426,640,3,1,0.968984902,396,528,92.95774648,82.5,98,626,27,423
dog,yolov8m,11709285374_bbb0e09e4e_z.jpg,477,640,3,1,0.943294346,384,423,80.50314465,66.09375,1,424,90,474
dog,yolov8m,11709285374_bbb0e09e4e_z.jpg,477,640,3,1,0.723240137,148,105,31.02725367,16.40625,0,105,22,170
dog,yolov8m,2698863450_3a10857081_z.jpg,590,639,3,1,0.920200527,560,575,94.91525424,89.98435055,63,638,24,584
dog,yolov8m,241832541_43848dabf3_z.jpg,639,426,3,1,0.938863754,637,414,99.68701095,97.18309859,0,414,1,638
dog,yolov8m,14869105327_a74f23fa8a_z.jpg,600,639,3,1,0.956462801,531,383,88.5,59.93740219,97,480,1,532
dog,yolov8m,2814480856_385049d567_z.jpg,480,640,3,1,0.940335274,380,397,79.16666667,62.03125,148,545,1,381
dog,yolov8m,8132134109_24eaa95e21_z.jpg,359,639,3,1,0.9302513,346,333,96.37883008,52.11267606,148,481,1,347
dog,yolov8m,7283869010_60b2e311b5_z.jpg,587,639,3,1,0.948976874,327,368,55.70698467,57.58998435,153,521,189,516
dog,yolov8m,4163439575_7c6a260e8e_z.jpg,521,640,3,1,0.955646336,480,404,92.13051823,63.125,51,455,29,509
dog,yolov8m,5290576324_881daf8265_z.jpg,480,640,3,1,0.893142521,175,123,36.45833333,19.21875,374,497,42,217
dog,yolov8m,5290576324_881daf8265_z.jpg,480,640,3,1,0.623103023,242,176,50.41666667,27.5,103,279,166,408
dog,yolov8m,13472183804_b6c8633f6e_z.jpg,500,640,3,1,0.931787312,268,253,53.6,39.53125,233,486,152,420
dog,yolov8m,2296897953_08627d83a0_z.jpg,640,480,3,1,0.931113899,638,434,99.6875,90.41666667,0,434,1,639
dog,yolov8m,14351072751_334621d203_z.jpg,480,640,3,1,0.817872882,243,264,50.625,41.25,163,427,47,290
dog,yolov8m,14351072751_334621d203_z.jpg,480,640,3,1,0.707449615,138,434,28.75,67.8125,155,589,246,384
dog,yolov8m,9159634981_ea2947ff02_z.jpg,640,480,3,1,0.847456634,542,451,84.6875,93.95833333,1,452,98,640
dog,yolov8m,9132297449_f27a6b1a45_z.jpg,612,612,3,1,0.938729942,521,390,85.13071895,63.7254902,82,472,26,547
dog,yolov8m,11381011104_36225e2ccc_z.jpg,543,640,3,1,0.942452013,504,490,92.81767956,76.5625,1,491,34,538
dog,yolov8m,11381011104_36225e2ccc_z.jpg,543,640,3,1,0.640560329,272,247,50.09208103,38.59375,392,639,268,540
dog,yolov8m,239427670_897dedb1ea_z.jpg,425,640,3,1,0.924858809,417,536,98.11764706,83.75,1,537,2,419
dog,yolov8m,4231227841_3821544fe1_z.jpg,608,640,3,1,0.824191332,436,230,71.71052632,35.9375,205,435,158,594
dog,yolov8m,3462334590_2b8f39c540_z.jpg,548,639,3,1,0.919570506,124,115,22.62773723,17.99687011,329,444,344,468
dog,yolov8m,9201197273_a98cb719f5_z.jpg,480,640,3,1,0.960229158,479,395,99.79166667,61.71875,1,396,0,479
dog,yolov8m,5381237016_f49e86b880_z.jpg,383,640,3,1,0.953740895,292,270,76.24020888,42.1875,1,271,35,327
dog,yolov8m,2040136228_41c284c2cb_z.jpg,640,494,3,1,0.960992932,401,308,62.65625,62.34817814,68,376,83,484
dog,yolov8m,4444608672_0fa9174b62_z.jpg,427,640,3,1,0.867826164,422,522,98.82903981,81.5625,0,522,0,422
dog,yolov8m,36110689_9cbbccb36a_z.jpg,496,640,3,1,0.936086476,465,586,93.75,91.5625,44,630,14,479
dog,yolov8m,13073061203_f7d640a8b3_z.jpg,428,639,3,1,0.942159653,200,381,46.72897196,59.62441315,0,381,84,284
dog,yolov8m,8730902798_bfe9360f4e_z.jpg,480,640,3,1,0.932486117,478,416,99.58333333,65,223,639,1,479
dog,yolov8m,489195247_b908298ee6_z.jpg,480,640,3,1,0.948020339,419,299,87.29166667,46.71875,191,490,60,479
dog,yolov8m,4018061968_3e03b2e96f_z.jpg,480,640,3,1,0.949007034,366,215,76.25,33.59375,223,438,53,419
dog,yolov8m,235979174_fcd7ef1374_z.jpg,640,480,3,1,0.953146696,537,302,83.90625,62.91666667,109,411,82,619
dog,yolov8m,15782459318_437c57f515_z.jpg,427,640,3,1,0.958478212,243,166,56.90866511,25.9375,367,533,182,425
dog,yolov8m,15782459318_437c57f515_z.jpg,427,640,3,1,0.957435548,261,165,61.12412178,25.78125,120,285,162,423
dog,yolov8m,4975505027_db5864977d_z.jpg,480,640,3,1,0.944721997,254,170,52.91666667,26.5625,415,585,106,360
dog,yolov8m,4975505027_db5864977d_z.jpg,480,640,3,1,0.919816732,139,152,28.95833333,23.75,335,487,223,362
dog,yolov8m,4975505027_db5864977d_z.jpg,480,640,3,1,0.874137282,137,139,28.54166667,21.71875,226,365,238,375
dog,yolov8m,4975505027_db5864977d_z.jpg,480,640,3,1,0.804434478,134,197,27.91666667,30.78125,30,227,242,376
dog,yolov8m,4975505027_db5864977d_z.jpg,480,640,3,1,0.653165698,257,235,53.54166667,36.71875,30,265,119,376
dog,yolov8m,4975505027_db5864977d_z.jpg,480,640,3,1,0.575033188,203,124,42.29166667,19.375,141,265,119,322
dog,yolov8m,4414731678_5f70c9f88e_z.jpg,480,640,3,1,0.814887226,285,416,59.375,65,136,552,86,371
dog,yolov8m,1570552254_fcac0be216_z.jpg,428,640,3,1,0.538081586,132,121,30.8411215,18.90625,449,570,90,222
dog,yolov8m,7492624590_e473685314_z.jpg,626,640,3,1,0.930892766,566,541,90.41533546,84.53125,55,596,45,611
dog,yolov8m,5652496789_70e6f301e9_z.jpg,427,640,3,1,0.948565423,317,510,74.23887588,79.6875,50,560,107,424
dog,yolov8m,104222040_c20f16bbc0_z.jpg,480,640,3,1,0.702019274,390,435,81.25,67.96875,52,487,90,480
dog,yolov8m,204668081_9bb000df17_z.jpg,550,640,3,1,0.959407151,371,386,67.45454545,60.3125,0,386,60,431
dog,yolov8m,7475018518_6c715a96c1_z.jpg,427,640,3,1,0.964464426,294,461,68.85245902,72.03125,52,513,74,368
dog,yolov8m,20843800936_edcdd89338_z.jpg,533,640,3,1,0.959382653,429,440,80.48780488,68.75,99,539,70,499
dog,yolov8m,319365750_c6ecd7afbc_z.jpg,480,640,3,1,0.955915987,335,377,69.79166667,58.90625,190,567,54,389
dog,yolov8m,2177634493_51ca0597e2_z.jpg,640,640,3,1,0.585256457,628,607,98.125,94.84375,24,631,6,634
dog,yolov8m,8591221048_8fe555a40c_z.jpg,427,640,3,1,0.959020197,383,380,89.69555035,59.375,126,506,24,407
dog,yolov8m,2787764752_0277f5bbb2_z.jpg,480,640,3,1,0.951741993,309,467,64.375,72.96875,84,551,111,420
dog,yolov8m,2592416858_f849d2ac8f_z.jpg,480,640,3,1,0.949057341,443,287,92.29166667,44.84375,303,590,37,480
dog,yolov8m,2592416858_f849d2ac8f_z.jpg,480,640,3,1,0.94238615,276,181,57.5,28.28125,9,190,203,479
dog,yolov8m,2592416858_f849d2ac8f_z.jpg,480,640,3,1,0.924417198,346,171,72.08333333,26.71875,166,337,134,480
dog,yolov8m,3197300261_4e5e9c5e3e_z.jpg,640,640,3,1,0.93032825,537,413,83.90625,64.53125,140,553,53,590
dog,yolov8m,16086668084_0d1665cda4_z.jpg,640,554,3,1,0.953082085,561,481,87.65625,86.82310469,19,500,79,640
dog,yolov8m,14409775264_5b589b56b4_z.jpg,480,640,3,1,0.95746547,414,396,86.25,61.875,29,425,60,474
dog,yolov8m,4467873253_2ce7540d62_z.jpg,427,640,3,1,0.926180542,409,528,95.78454333,82.5,35,563,13,422
dog,yolov8m,105398161_799ded9b2a_z.jpg,640,480,3,1,0.915166855,445,395,69.53125,82.29166667,73,468,97,542
dog,yolov8m,252889263_3cf2d57f34_z.jpg,480,640,3,1,0.918232858,417,251,86.875,39.21875,218,469,53,470
dog,yolov8m,1134141407_0254c76c4d_z.jpg,384,640,3,1,0.890677392,343,424,89.32291667,66.25,14,438,40,383
dog,yolov8m,3676100181_dc21ca177f_z.jpg,640,480,3,1,0.934962392,134,142,20.9375,29.58333333,119,261,387,521
dog,yolov8n,7270802858_c6e2b115e4_z.jpg,640,640,3,1,0.918588519,299,389,46.71875,60.78125,113,502,235,534
dog,yolov8n,5753318048_1cde42cb1f_z.jpg,512,640,3,1,0.921595991,511,503,99.8046875,78.59375,0,503,1,512
dog,yolov8n,890847666_ec8eaecf88_z.jpg,640,480,3,1,0.914337337,374,259,58.4375,53.95833333,0,259,266,640
dog,yolov8n,809525484_e2e6f137aa_z.jpg,480,640,3,1,0.647650421,280,501,58.33333333,78.28125,87,588,200,480
dog,yolov8n,809525484_e2e6f137aa_z.jpg,480,640,3,1,0.493678451,370,415,77.08333333,64.84375,172,587,108,478
dog,yolov8n,809525484_e2e6f137aa_z.jpg,480,640,3,1,0.397834897,261,391,54.375,61.09375,66,457,218,479
dog,yolov8n,809525484_e2e6f137aa_z.jpg,480,640,3,1,0.289201587,368,374,76.66666667,58.4375,63,437,110,478
dog,yolov8n,2169952827_05bddc305e_z.jpg,427,640,3,1,0.926772177,390,560,91.33489461,87.5,80,640,37,427
dog,yolov8n,20959877010_552298f5f8_z.jpg,367,640,3,1,0.90351218,272,272,74.11444142,42.5,301,573,81,353
dog,yolov8n,20959877010_552298f5f8_z.jpg,367,640,3,1,0.867545843,320,296,87.19346049,46.25,21,317,5,325
dog,yolov8n,3290610375_c742148226_z.jpg,428,639,3,1,0.908112645,352,382,82.24299065,59.78090767,22,404,71,423
dog,yolov8n,2433596596_377bb91619_z.jpg,491,640,3,1,0.342454672,175,134,35.64154786,20.9375,506,640,28,203
dog,yolov8n,6113997729_5f5ac02209_z.jpg,480,640,3,1,0.937059999,341,319,71.04166667,49.84375,165,484,56,397
dog,yolov8n,2277306387_af18b2096e_z.jpg,483,640,3,1,0.606738448,441,442,91.30434783,69.0625,135,577,4,445
dog,yolov8n,81717243_2c9fcf3dab_z.jpg,508,640,3,1,0.864280939,339,290,66.73228346,45.3125,205,495,126,465
dog,yolov8n,8343384446_ebe3bc86ce_z.jpg,640,617,3,1,0.850481451,506,302,79.0625,48.9465154,143,445,75,581
dog,yolov8n,2167290248_1ac3cbd890_z.jpg,639,485,3,0,0,0,0,0,0,0,0,0,0
dog,yolov8n,915541987_2627e91a14_z.jpg,640,431,3,1,0.312348485,488,412,76.25,95.59164733,17,429,133,621
dog,yolov8n,5878631770_0c5592a1ee_z.jpg,427,640,3,1,0.862564564,323,496,75.6440281,77.5,106,602,98,421
dog,yolov8n,3209962531_f75dbe4341_z.jpg,445,639,3,1,0.80595845,397,516,89.21348315,80.75117371,121,637,40,437
dog,yolov8n,16107639462_07e2d4455d_z.jpg,427,640,3,1,0.655352414,373,428,87.35362998,66.875,115,543,47,420
dog,yolov8n,3291298501_9a8eed3fa0_z.jpg,427,640,3,1,0.866984904,368,494,86.18266979,77.1875,0,494,57,425
dog,yolov8n,34095624_ce7c705614_z.jpg,480,640,3,1,0.689549863,455,560,94.79166667,87.5,79,639,25,480
dog,yolov8n,4122228889_3b69997e0c_z.jpg,640,478,3,1,0.917911947,375,298,58.59375,62.34309623,86,384,149,524
dog,yolov8n,6897439523_236f77f06f_z.jpg,452,640,3,1,0.911754251,324,383,71.68141593,59.84375,49,432,39,363
dog,yolov8n,6897439523_236f77f06f_z.jpg,452,640,3,1,0.86608392,329,218,72.78761062,34.0625,398,616,108,437
dog,yolov8n,7248771448_66aab6455d_z.jpg,495,640,3,1,0.656187713,436,504,88.08080808,78.75,50,554,12,448
dog,yolov8n,6238072987_89f2925563_z.jpg,640,480,3,1,0.891984642,555,395,86.71875,82.29166667,85,480,84,639
dog,yolov8n,84410494_ab268290cf_z.jpg,480,640,3,1,0.440567881,478,397,99.58333333,62.03125,161,558,1,479
dog,yolov8n,19030996840_1fbbb14eeb_z.jpg,640,640,3,1,0.739428341,519,522,81.09375,81.5625,62,584,34,553
dog,yolov8n,19030996840_1fbbb14eeb_z.jpg,640,640,3,1,0.273329079,310,236,48.4375,36.875,167,403,256,566
dog,yolov8n,5093076088_7bc77ec199_z.jpg,480,640,3,1,0.926638365,160,151,33.33333333,23.59375,333,484,234,394
dog,yolov8n,5093076088_7bc77ec199_z.jpg,480,640,3,1,0.922614336,194,226,40.41666667,35.3125,120,346,134,328
dog,yolov8n,5093076088_7bc77ec199_z.jpg,480,640,3,1,0.488809705,89,74,18.54166667,11.5625,0,74,127,216
dog,yolov8n,387284206_360c4e3d6e_z.jpg,313,639,3,1,0.662578583,301,597,96.16613419,93.42723005,35,632,11,312
dog,yolov8n,677743874_168dcb5ed1_z.jpg,427,640,3,1,0.900483012,228,213,53.39578454,33.28125,294,507,81,309
dog,yolov8n,3968015804_ac83717a19_z.jpg,427,640,3,1,0.858500123,378,396,88.52459016,61.875,116,512,45,423
dog,yolov8n,9031823026_3e55960d76_z.jpg,384,640,3,1,0.820788503,279,457,72.65625,71.40625,123,580,83,362
dog,yolov8n,7928462126_bb6f3a98bf_z.jpg,427,640,3,1,0.655003011,416,474,97.42388759,74.0625,0,474,0,416
dog,yolov8n,19309035192_8666b8c4e2_z.jpg,480,640,3,1,0.467758238,334,537,69.58333333,83.90625,0,537,110,444
dog,yolov8n,14584923986_debd346d81_z.jpg,640,640,3,1,0.804063737,634,637,99.0625,99.53125,2,639,2,636
dog,yolov8n,5827517048_a890acd7e6_z.jpg,424,640,3,1,0.654414117,265,281,62.5,43.90625,359,640,131,396
dog,yolov8n,5827517048_a890acd7e6_z.jpg,424,640,3,1,0.452370077,135,202,31.83962264,31.5625,305,507,83,218
dog,yolov8n,3850147043_06970bc680_z.jpg,480,640,3,1,0.886207759,239,447,49.79166667,69.84375,59,506,46,285
dog,yolov8n,506974894_b74672813b_z.jpg,427,640,3,1,0.82115072,291,470,68.1498829,73.4375,3,473,80,371
dog,yolov8n,506974894_b74672813b_z.jpg,427,640,3,1,0.318472058,116,356,27.16627635,55.625,184,540,1,117
dog,yolov8n,4941417139_1608ab2596_z.jpg,480,640,3,1,0.663557649,420,630,87.5,98.4375,2,632,60,480
dog,yolov8n,361146297_ca9b5c8799_z.jpg,640,480,3,1,0.845859528,534,477,83.4375,99.375,3,480,106,640
dog,yolov8n,19283436_772222a19e_z.jpg,472,640,3,1,0.864920259,366,237,77.54237288,37.03125,216,453,99,465
dog,yolov8n,5589760101_cf3ec6080e_z.jpg,424,640,3,1,0.643503428,417,537,98.3490566,83.90625,86,623,1,418
dog,yolov8n,20646999908_c3400d3ef6_z.jpg,480,640,3,1,0.848078132,444,599,92.5,93.59375,32,631,36,480
dog,yolov8n,7443993440_80892cc39d_z.jpg,620,640,3,1,0.869803965,396,430,63.87096774,67.1875,100,530,121,517
dog,yolov8n,3812603979_2102c37672_z.jpg,426,640,3,1,0.874438941,399,537,93.66197183,83.90625,91,628,22,421
dog,yolov8n,11709285374_bbb0e09e4e_z.jpg,477,640,3,1,0.829218507,389,424,81.55136268,66.25,0,424,88,477
dog,yolov8n,2698863450_3a10857081_z.jpg,590,639,3,1,0.778519154,566,465,95.93220339,72.76995305,110,575,21,587
dog,yolov8n,2698863450_3a10857081_z.jpg,590,639,3,1,0.31888321,553,400,93.72881356,62.59780908,65,465,27,580
dog,yolov8n,241832541_43848dabf3_z.jpg,639,426,3,1,0.904479921,639,405,100,95.07042254,0,405,0,639
dog,yolov8n,14869105327_a74f23fa8a_z.jpg,600,639,3,1,0.717480958,504,395,84,61.81533646,89,484,22,526
dog,yolov8n,2814480856_385049d567_z.jpg,480,640,3,1,0.729702652,382,395,79.58333333,61.71875,151,546,1,383
dog,yolov8n,8132134109_24eaa95e21_z.jpg,359,639,3,1,0.405964017,347,329,96.65738162,51.48669797,146,475,1,348
dog,yolov8n,7283869010_60b2e311b5_z.jpg,587,639,3,1,0.591783106,325,367,55.36626917,57.43348983,156,523,190,515
dog,yolov8n,4163439575_7c6a260e8e_z.jpg,521,640,3,1,0.854540706,490,422,94.04990403,65.9375,44,466,23,513
dog,yolov8n,5290576324_881daf8265_z.jpg,480,640,3,1,0.890366256,176,123,36.66666667,19.21875,375,498,42,218
dog,yolov8n,5290576324_881daf8265_z.jpg,480,640,3,1,0.550742388,238,178,49.58333333,27.8125,102,280,170,408
dog,yolov8n,13472183804_b6c8633f6e_z.jpg,500,640,3,1,0.729353011,281,253,56.2,39.53125,234,487,147,428
dog,yolov8n,2296897953_08627d83a0_z.jpg,640,480,3,1,0.915638566,633,443,98.90625,92.29166667,1,444,7,640
dog,yolov8n,14351072751_334621d203_z.jpg,480,640,3,1,0.561257243,131,426,27.29166667,66.5625,164,590,257,388
dog,yolov8n,9159634981_ea2947ff02_z.jpg,640,480,3,1,0.390904009,165,202,25.78125,42.08333333,121,323,94,259
dog,yolov8n,9159634981_ea2947ff02_z.jpg,640,480,3,1,0.322255939,529,464,82.65625,96.66666667,0,464,111,640
dog,yolov8n,9159634981_ea2947ff02_z.jpg,640,480,3,1,0.259905368,501,325,78.28125,67.70833333,0,325,96,597
dog,yolov8n,9132297449_f27a6b1a45_z.jpg,612,612,3,1,0.743743241,555,399,90.68627451,65.19607843,71,470,27,582
dog,yolov8n,11381011104_36225e2ccc_z.jpg,543,640,3,1,0.766210198,496,428,91.34438306,66.875,65,493,36,532
dog,yolov8n,11381011104_36225e2ccc_z.jpg,543,640,3,1,0.485475898,274,247,50.46040516,38.59375,393,640,269,543
dog,yolov8n,239427670_897dedb1ea_z.jpg,425,640,3,1,0.797867954,419,534,98.58823529,83.4375,16,550,3,422
dog,yolov8n,4231227841_3821544fe1_z.jpg,608,640,3,1,0.868545711,449,226,73.84868421,35.3125,204,430,153,602
dog,yolov8n,3462334590_2b8f39c540_z.jpg,548,639,3,1,0.894826293,124,115,22.62773723,17.99687011,328,443,346,470
dog,yolov8n,9201197273_a98cb719f5_z.jpg,480,640,3,1,0.651249409,469,396,97.70833333,61.875,0,396,10,479
dog,yolov8n,5381237016_f49e86b880_z.jpg,383,640,3,1,0.848736465,294,271,76.76240209,42.34375,1,272,33,327
dog,yolov8n,2040136228_41c284c2cb_z.jpg,640,494,3,1,0.894272327,401,308,62.65625,62.34817814,69,377,81,482
dog,yolov8n,4444608672_0fa9174b62_z.jpg,427,640,3,0,0,0,0,0,0,0,0,0,0
dog,yolov8n,36110689_9cbbccb36a_z.jpg,496,640,3,1,0.778096497,474,587,95.56451613,91.71875,49,636,11,485
dog,yolov8n,13073061203_f7d640a8b3_z.jpg,428,639,3,1,0.856522381,198,379,46.26168224,59.3114241,1,380,86,284
dog,yolov8n,8730902798_bfe9360f4e_z.jpg,480,640,3,1,0.849980056,475,418,98.95833333,65.3125,222,640,4,479
dog,yolov8n,489195247_b908298ee6_z.jpg,480,640,3,1,0.838714302,424,313,88.33333333,48.90625,185,498,56,480
dog,yolov8n,4018061968_3e03b2e96f_z.jpg,480,640,3,1,0.914982975,365,216,76.04166667,33.75,221,437,56,421
dog,yolov8n,235979174_fcd7ef1374_z.jpg,640,480,3,1,0.880247116,555,306,86.71875,63.75,105,411,69,624
dog,yolov8n,15782459318_437c57f515_z.jpg,427,640,3,1,0.9355551,266,165,62.29508197,25.78125,120,285,158,424
dog,yolov8n,15782459318_437c57f515_z.jpg,427,640,3,1,0.929619968,243,166,56.90866511,25.9375,367,533,181,424
dog,yolov8n,4975505027_db5864977d_z.jpg,480,640,3,1,0.919938445,255,170,53.125,26.5625,415,585,106,361
dog,yolov8n,4975505027_db5864977d_z.jpg,480,640,3,1,0.696868896,138,148,28.75,23.125,338,486,224,362
dog,yolov8n,4975505027_db5864977d_z.jpg,480,640,3,1,0.543794453,255,235,53.125,36.71875,30,265,120,375
dog,yolov8n,4975505027_db5864977d_z.jpg,480,640,3,1,0.259527773,137,146,28.54166667,22.8125,226,372,239,376
dog,yolov8n,4414731678_5f70c9f88e_z.jpg,480,640,3,1,0.656513691,287,406,59.79166667,63.4375,145,551,85,372
dog,yolov8n,1570552254_fcac0be216_z.jpg,428,640,3,0,0,0,0,0,0,0,0,0,0
dog,yolov8n,7492624590_e473685314_z.jpg,626,640,3,1,0.773149371,547,592,87.38019169,92.5,19,611,69,616
dog,yolov8n,5652496789_70e6f301e9_z.jpg,427,640,3,1,0.366209716,317,477,74.23887588,74.53125,83,560,105,422
dog,yolov8n,104222040_c20f16bbc0_z.jpg,480,640,3,0,0,0,0,0,0,0,0,0,0
dog,yolov8n,204668081_9bb000df17_z.jpg,550,640,3,1,0.935065567,372,388,67.63636364,60.625,1,389,59,431
dog,yolov8n,7475018518_6c715a96c1_z.jpg,427,640,3,1,0.931329429,292,460,68.38407494,71.875,56,516,77,369
dog,yolov8n,20843800936_edcdd89338_z.jpg,533,640,3,1,0.889593244,432,447,81.05065666,69.84375,97,544,71,503
dog,yolov8n,319365750_c6ecd7afbc_z.jpg,480,640,3,1,0.848342717,334,379,69.58333333,59.21875,189,568,56,390
dog,yolov8n,2177634493_51ca0597e2_z.jpg,640,640,3,0,0,0,0,0,0,0,0,0,0
dog,yolov8n,8591221048_8fe555a40c_z.jpg,427,640,3,1,0.926774204,378,371,88.52459016,57.96875,139,510,24,402
dog,yolov8n,2787764752_0277f5bbb2_z.jpg,480,640,3,1,0.849278152,317,490,66.04166667,76.5625,67,557,111,428
dog,yolov8n,2592416858_f849d2ac8f_z.jpg,480,640,3,1,0.885571957,444,285,92.5,44.53125,306,591,36,480
dog,yolov8n,2592416858_f849d2ac8f_z.jpg,480,640,3,1,0.882881343,275,179,57.29166667,27.96875,10,189,205,480
dog,yolov8n,2592416858_f849d2ac8f_z.jpg,480,640,3,1,0.838834465,345,169,71.875,26.40625,168,337,135,480
dog,yolov8n,3197300261_4e5e9c5e3e_z.jpg,640,640,3,1,0.817439973,533,419,83.28125,65.46875,140,559,58,591
dog,yolov8n,16086668084_0d1665cda4_z.jpg,640,554,3,1,0.888319492,560,495,87.5,89.35018051,21,516,79,639
dog,yolov8n,14409775264_5b589b56b4_z.jpg,480,640,3,1,0.865850925,417,400,86.875,62.5,25,425,51,468
dog,yolov8n,4467873253_2ce7540d62_z.jpg,427,640,3,1,0.808740139,416,525,97.42388759,82.03125,47,572,7,423
dog,yolov8n,105398161_799ded9b2a_z.jpg,640,480,3,1,0.885464847,461,410,72.03125,85.41666667,69,479,83,544
dog,yolov8n,252889263_3cf2d57f34_z.jpg,480,640,3,1,0.315035611,423,259,88.125,40.46875,215,474,54,477
dog,yolov8n,1134141407_0254c76c4d_z.jpg,384,640,3,1,0.833457589,374,434,97.39583333,67.8125,6,440,10,384
dog,yolov8n,3676100181_dc21ca177f_z.jpg,640,480,3,1,0.92159313,135,140,21.09375,29.16666667,122,262,388,523
dog,yolov8s,7270802858_c6e2b115e4_z.jpg,640,640,3,1,0.924503267,298,383,46.5625,59.84375,113,496,238,536
dog,yolov8s,5753318048_1cde42cb1f_z.jpg,512,640,3,1,0.936179757,511,506,99.8046875,79.0625,0,506,1,512
dog,yolov8s,890847666_ec8eaecf88_z.jpg,640,480,3,1,0.914776266,368,258,57.5,53.75,0,258,271,639
dog,yolov8s,809525484_e2e6f137aa_z.jpg,480,640,3,1,0.734065533,370,533,77.08333333,83.28125,61,594,109,479
dog,yolov8s,2169952827_05bddc305e_z.jpg,427,640,3,1,0.925456405,391,563,91.56908665,87.96875,76,639,35,426
dog,yolov8s,20959877010_552298f5f8_z.jpg,367,640,3,1,0.934304059,322,299,87.73841962,46.71875,20,319,5,327
dog,yolov8s,20959877010_552298f5f8_z.jpg,367,640,3,1,0.915039897,281,336,76.56675749,52.5,298,634,72,353
dog,yolov8s,3290610375_c742148226_z.jpg,428,639,3,1,0.924730837,357,384,83.41121495,60.09389671,21,405,66,423
dog,yolov8s,2433596596_377bb91619_z.jpg,491,640,3,1,0.908128083,172,135,35.0305499,21.09375,505,640,29,201
dog,yolov8s,6113997729_5f5ac02209_z.jpg,480,640,3,1,0.93626684,337,316,70.20833333,49.375,168,484,58,395
dog,yolov8s,2277306387_af18b2096e_z.jpg,483,640,3,1,0.871178448,433,441,89.64803313,68.90625,138,579,6,439
dog,yolov8s,81717243_2c9fcf3dab_z.jpg,508,640,3,1,0.947542191,339,288,66.73228346,45,207,495,127,466
dog,yolov8s,8343384446_ebe3bc86ce_z.jpg,640,617,3,1,0.879276216,521,300,81.40625,48.62236629,143,443,68,589
dog,yolov8s,2167290248_1ac3cbd890_z.jpg,639,485,3,1,0.885470569,594,385,92.95774648,79.3814433,43,428,45,639
dog,yolov8s,915541987_2627e91a14_z.jpg,640,431,3,1,0.745876968,504,431,78.75,100,0,431,129,633
dog,yolov8s,5878631770_0c5592a1ee_z.jpg,427,640,3,1,0.820444942,322,532,75.40983607,83.125,105,637,100,422
dog,yolov8s,3209962531_f75dbe4341_z.jpg,445,639,3,1,0.926373661,398,513,89.43820225,80.28169014,125,638,44,442
dog,yolov8s,16107639462_07e2d4455d_z.jpg,427,640,3,1,0.811414123,374,356,87.58782201,55.625,125,481,48,422
dog,yolov8s,3291298501_9a8eed3fa0_z.jpg,427,640,3,1,0.903870702,368,501,86.18266979,78.28125,1,502,56,424
dog,yolov8s,34095624_ce7c705614_z.jpg,480,640,3,1,0.92139405,453,612,94.375,95.625,27,639,27,480
dog,yolov8s,4122228889_3b69997e0c_z.jpg,640,478,3,1,0.91356653,371,314,57.96875,65.69037657,69,383,151,522
dog,yolov8s,6897439523_236f77f06f_z.jpg,452,640,3,1,0.923580766,315,330,69.69026549,51.5625,49,379,47,362
dog,yolov8s,6897439523_236f77f06f_z.jpg,452,640,3,1,0.763371706,330,220,73.00884956,34.375,397,617,104,434
dog,yolov8s,6897439523_236f77f06f_z.jpg,452,640,3,1,0.612311542,309,159,68.36283186,24.84375,285,444,49,358
dog,yolov8s,7248771448_66aab6455d_z.jpg,495,640,3,1,0.863849163,411,504,83.03030303,78.75,58,562,32,443
dog,yolov8s,6238072987_89f2925563_z.jpg,640,480,3,1,0.863687873,558,400,87.1875,83.33333333,79,479,81,639
dog,yolov8s,84410494_ab268290cf_z.jpg,480,640,3,1,0.815290451,477,380,99.375,59.375,150,530,2,479
dog,yolov8s,19030996840_1fbbb14eeb_z.jpg,640,640,3,1,0.918176174,386,404,60.3125,63.125,0,404,254,640
dog,yolov8s,19030996840_1fbbb14eeb_z.jpg,640,640,3,1,0.725229621,467,509,72.96875,79.53125,82,591,37,504
dog,yolov8s,5093076088_7bc77ec199_z.jpg,480,640,3,1,0.93725127,194,224,40.41666667,35,122,346,134,328
dog,yolov8s,5093076088_7bc77ec199_z.jpg,480,640,3,1,0.914810061,159,149,33.125,23.28125,335,484,234,393
dog,yolov8s,5093076088_7bc77ec199_z.jpg,480,640,3,1,0.483754456,85,73,17.70833333,11.40625,0,73,129,214
dog,yolov8s,387284206_360c4e3d6e_z.jpg,313,639,3,1,0.755527556,302,606,96.485623,94.83568075,31,637,8,310
dog,yolov8s,677743874_168dcb5ed1_z.jpg,427,640,3,1,0.917316377,233,209,54.56674473,32.65625,296,505,75,308
dog,yolov8s,677743874_168dcb5ed1_z.jpg,427,640,3,1,0.629675806,44,104,10.30444965,16.25,297,401,53,97
dog,yolov8s,3968015804_ac83717a19_z.jpg,427,640,3,1,0.90752703,375,390,87.82201405,60.9375,122,512,46,421
dog,yolov8s,9031823026_3e55960d76_z.jpg,384,640,3,1,0.596568346,278,468,72.39583333,73.125,111,579,83,361
dog,yolov8s,7928462126_bb6f3a98bf_z.jpg,427,640,3,1,0.936361074,423,463,99.06323185,72.34375,15,478,0,423
dog,yolov8s,19309035192_8666b8c4e2_z.jpg,480,640,3,1,0.904265523,334,560,69.58333333,87.5,0,560,109,443
dog,yolov8s,14584923986_debd346d81_z.jpg,640,640,3,1,0.797197342,634,638,99.0625,99.6875,1,639,2,636
dog,yolov8s,5827517048_a890acd7e6_z.jpg,424,640,3,1,0.935044348,265,284,62.5,44.375,356,640,131,396
dog,yolov8s,5827517048_a890acd7e6_z.jpg,424,640,3,1,0.88585037,141,204,33.25471698,31.875,305,509,81,222
dog,yolov8s,3850147043_06970bc680_z.jpg,480,640,3,1,0.934592485,241,439,50.20833333,68.59375,68,507,45,286
dog,yolov8s,506974894_b74672813b_z.jpg,427,640,3,1,0.868718386,288,468,67.44730679,73.125,2,470,79,367
dog,yolov8s,506974894_b74672813b_z.jpg,427,640,3,1,0.834333539,115,350,26.93208431,54.6875,187,537,0,115
dog,yolov8s,4941417139_1608ab2596_z.jpg,480,640,3,1,0.81386739,431,637,89.79166667,99.53125,1,638,45,476
dog,yolov8s,361146297_ca9b5c8799_z.jpg,640,480,3,1,0.573193073,548,466,85.625,97.08333333,13,479,92,640
dog,yolov8s,19283436_772222a19e_z.jpg,472,640,3,1,0.930989861,370,245,78.38983051,38.28125,214,459,99,469
dog,yolov8s,5589760101_cf3ec6080e_z.jpg,424,640,3,1,0.89391917,421,543,99.29245283,84.84375,89,632,0,421
dog,yolov8s,20646999908_c3400d3ef6_z.jpg,480,640,3,1,0.797576308,435,602,90.625,94.0625,25,627,45,480
dog,yolov8s,20646999908_c3400d3ef6_z.jpg,480,640,3,1,0.282713264,115,287,23.95833333,44.84375,1,288,365,480
dog,yolov8s,7443993440_80892cc39d_z.jpg,620,640,3,1,0.89616555,392,423,63.22580645,66.09375,99,522,120,512
dog,yolov8s,3812603979_2102c37672_z.jpg,426,640,3,1,0.885484934,397,543,93.19248826,84.84375,90,633,25,422
dog,yolov8s,11709285374_bbb0e09e4e_z.jpg,477,640,3,1,0.895876527,386,410,80.92243187,64.0625,2,412,89,475
dog,yolov8s,11709285374_bbb0e09e4e_z.jpg,477,640,3,1,0.634718776,151,104,31.65618449,16.25,0,104,20,171
dog,yolov8s,2698863450_3a10857081_z.jpg,590,639,3,1,0.880135715,571,527,96.77966102,82.47261346,110,637,14,585
dog,yolov8s,241832541_43848dabf3_z.jpg,639,426,3,1,0.913321614,637,406,99.68701095,95.30516432,0,406,1,638
dog,yolov8s,14869105327_a74f23fa8a_z.jpg,600,639,3,1,0.892729044,532,390,88.66666667,61.03286385,92,482,3,535
dog,yolov8s,2814480856_385049d567_z.jpg,480,640,3,1,0.888456941,380,397,79.16666667,62.03125,146,543,1,381
dog,yolov8s,8132134109_24eaa95e21_z.jpg,359,639,3,1,0.871907234,348,331,96.93593315,51.79968701,149,480,0,348
dog,yolov8s,7283869010_60b2e311b5_z.jpg,587,639,3,1,0.606105864,329,362,56.04770017,56.65101721,156,518,188,517
dog,yolov8s,4163439575_7c6a260e8e_z.jpg,521,640,3,1,0.916934073,487,406,93.47408829,63.4375,50,456,26,513
dog,yolov8s,5290576324_881daf8265_z.jpg,480,640,3,1,0.942643285,176,123,36.66666667,19.21875,375,498,42,218
dog,yolov8s,5290576324_881daf8265_z.jpg,480,640,3,1,0.91821748,242,177,50.41666667,27.65625,103,280,166,408
dog,yolov8s,13472183804_b6c8633f6e_z.jpg,500,640,3,1,0.815630317,273,282,54.6,44.0625,232,514,147,420
dog,yolov8s,2296897953_08627d83a0_z.jpg,640,480,3,1,0.892614424,636,434,99.375,90.41666667,1,435,2,638
dog,yolov8s,14351072751_334621d203_z.jpg,480,640,3,1,0.849023342,244,262,50.83333333,40.9375,165,427,47,291
dog,yolov8s,14351072751_334621d203_z.jpg,480,640,3,1,0.663762033,130,427,27.08333333,66.71875,158,585,254,384
dog,yolov8s,9159634981_ea2947ff02_z.jpg,640,480,3,1,0.671070158,434,323,67.8125,67.29166667,0,323,92,526
dog,yolov8s,9132297449_f27a6b1a45_z.jpg,612,612,3,1,0.889521062,557,379,91.0130719,61.92810458,83,462,36,593
dog,yolov8s,11381011104_36225e2ccc_z.jpg,543,640,3,1,0.828523815,508,490,93.55432781,76.5625,0,490,31,539
dog,yolov8s,11381011104_36225e2ccc_z.jpg,543,640,3,1,0.772756696,273,249,50.27624309,38.90625,390,639,270,543
dog,yolov8s,239427670_897dedb1ea_z.jpg,425,640,3,1,0.677707374,417,521,98.11764706,81.40625,102,623,4,421
dog,yolov8s,4231227841_3821544fe1_z.jpg,608,640,3,1,0.898041368,437,225,71.875,35.15625,205,430,159,596
dog,yolov8s,3462334590_2b8f39c540_z.jpg,548,639,3,1,0.927346349,124,115,22.62773723,17.99687011,329,444,345,469
dog,yolov8s,9201197273_a98cb719f5_z.jpg,480,640,3,1,0.941023469,464,395,96.66666667,61.71875,0,395,16,480
dog,yolov8s,5381237016_f49e86b880_z.jpg,383,640,3,1,0.93380338,294,270,76.76240209,42.1875,1,271,34,328
dog,yolov8s,2040136228_41c284c2cb_z.jpg,640,494,3,1,0.927636445,404,307,63.125,62.14574899,69,376,80,484
dog,yolov8s,4444608672_0fa9174b62_z.jpg,427,640,3,1,0.609444857,422,525,98.82903981,82.03125,0,525,0,422
dog,yolov8s,36110689_9cbbccb36a_z.jpg,496,640,3,1,0.838531852,475,574,95.76612903,89.6875,51,625,10,485
dog,yolov8s,13073061203_f7d640a8b3_z.jpg,428,639,3,1,0.941164553,199,378,46.4953271,59.15492958,1,379,84,283
dog,yolov8s,8730902798_bfe9360f4e_z.jpg,480,640,3,1,0.870135665,478,417,99.58333333,65.15625,221,638,1,479
dog,yolov8s,489195247_b908298ee6_z.jpg,480,640,3,1,0.923180282,418,297,87.08333333,46.40625,193,490,62,480
dog,yolov8s,4018061968_3e03b2e96f_z.jpg,480,640,3,1,0.909814775,358,215,74.58333333,33.59375,223,438,61,419
dog,yolov8s,235979174_fcd7ef1374_z.jpg,640,480,3,1,0.928332388,549,305,85.78125,63.54166667,106,411,78,627
dog,yolov8s,15782459318_437c57f515_z.jpg,427,640,3,1,0.94961518,244,166,57.14285714,25.9375,367,533,181,425
dog,yolov8s,15782459318_437c57f515_z.jpg,427,640,3,1,0.917801976,266,166,62.29508197,25.9375,119,285,158,424
dog,yolov8s,4975505027_db5864977d_z.jpg,480,640,3,1,0.88013345,253,171,52.70833333,26.71875,414,585,107,360
dog,yolov8s,4975505027_db5864977d_z.jpg,480,640,3,1,0.697217941,141,147,29.375,22.96875,335,482,223,364
dog,yolov8s,4975505027_db5864977d_z.jpg,480,640,3,1,0.505997837,256,235,53.33333333,36.71875,29,264,120,376
dog,yolov8s,4414731678_5f70c9f88e_z.jpg,480,640,3,1,0.844578505,284,413,59.16666667,64.53125,138,551,88,372
dog,yolov8s,1570552254_fcac0be216_z.jpg,428,640,3,1,0.362149298,129,119,30.14018692,18.59375,451,570,92,221
dog,yolov8s,7492624590_e473685314_z.jpg,626,640,3,1,0.824034333,568,602,90.73482428,94.0625,14,616,45,613
dog,yolov8s,5652496789_70e6f301e9_z.jpg,427,640,3,1,0.93529588,315,509,73.7704918,79.53125,46,555,107,422
dog,yolov8s,104222040_c20f16bbc0_z.jpg,480,640,3,0,0,0,0,0,0,0,0,0,0
dog,yolov8s,204668081_9bb000df17_z.jpg,550,640,3,1,0.926637888,374,383,68,59.84375,3,386,60,434
dog,yolov8s,7475018518_6c715a96c1_z.jpg,427,640,3,1,0.934890509,289,455,67.68149883,71.09375,56,511,79,368
dog,yolov8s,20843800936_edcdd89338_z.jpg,533,640,3,1,0.902456164,428,439,80.30018762,68.59375,100,539,71,499
dog,yolov8s,319365750_c6ecd7afbc_z.jpg,480,640,3,1,0.911752105,335,387,69.79166667,60.46875,189,576,54,389
dog,yolov8s,2177634493_51ca0597e2_z.jpg,640,640,3,1,0.320102245,628,573,98.125,89.53125,47,620,8,636
dog,yolov8s,8591221048_8fe555a40c_z.jpg,427,640,3,1,0.925591707,383,376,89.69555035,58.75,131,507,24,407
dog,yolov8s,2787764752_0277f5bbb2_z.jpg,480,640,3,1,0.914332628,310,478,64.58333333,74.6875,78,556,111,421
dog,yolov8s,2592416858_f849d2ac8f_z.jpg,480,640,3,1,0.933235943,443,281,92.29166667,43.90625,309,590,37,480
dog,yolov8s,2592416858_f849d2ac8f_z.jpg,480,640,3,1,0.923889816,345,171,71.875,26.71875,166,337,134,479
dog,yolov8s,2592416858_f849d2ac8f_z.jpg,480,640,3,1,0.903927386,277,180,57.70833333,28.125,9,189,203,480
dog,yolov8s,3197300261_4e5e9c5e3e_z.jpg,640,640,3,1,0.829461157,517,423,80.78125,66.09375,139,562,66,583
dog,yolov8s,16086668084_0d1665cda4_z.jpg,640,554,3,1,0.838433087,558,503,87.1875,90.79422383,5,508,82,640
dog,yolov8s,14409775264_5b589b56b4_z.jpg,480,640,3,1,0.734054863,416,401,86.66666667,62.65625,28,429,56,472
dog,yolov8s,4467873253_2ce7540d62_z.jpg,427,640,3,1,0.67183882,405,479,94.84777518,74.84375,45,524,17,422
dog,yolov8s,4467873253_2ce7540d62_z.jpg,427,640,3,1,0.2885499,403,282,94.3793911,44.0625,29,311,18,421
dog,yolov8s,105398161_799ded9b2a_z.jpg,640,480,3,1,0.898010314,445,402,69.53125,83.75,70,472,98,543
dog,yolov8s,252889263_3cf2d57f34_z.jpg,480,640,3,1,0.904194474,419,251,87.29166667,39.21875,218,469,54,473
dog,yolov8s,1134141407_0254c76c4d_z.jpg,384,640,3,1,0.900499046,342,350,89.0625,54.6875,87,437,41,383
dog,yolov8s,3676100181_dc21ca177f_z.jpg,640,480,3,1,0.922544003,134,141,20.9375,29.375,120,261,387,521
dog,yolov8x,7270802858_c6e2b115e4_z.jpg,640,640,3,1,0.975082994,297,383,46.40625,59.84375,114,497,238,535
dog,yolov8x,5753318048_1cde42cb1f_z.jpg,512,640,3,1,0.981596053,504,503,98.4375,78.59375,1,504,7,511
dog,yolov8x,890847666_ec8eaecf88_z.jpg,640,480,3,1,0.970730901,370,259,57.8125,53.95833333,1,260,269,639
dog,yolov8x,809525484_e2e6f137aa_z.jpg,480,640,3,1,0.957816303,368,537,76.66666667,83.90625,58,595,111,479
dog,yolov8x,2169952827_05bddc305e_z.jpg,427,640,3,1,0.970873833,387,557,90.6323185,87.03125,83,640,35,422
dog,yolov8x,20959877010_552298f5f8_z.jpg,367,640,3,1,0.96215409,318,298,86.64850136,46.5625,20,318,6,324
dog,yolov8x,20959877010_552298f5f8_z.jpg,367,640,3,1,0.957514703,279,337,76.02179837,52.65625,300,637,74,353
dog,yolov8x,3290610375_c742148226_z.jpg,428,639,3,1,0.762891173,353,383,82.47663551,59.93740219,19,402,67,420
dog,yolov8x,2433596596_377bb91619_z.jpg,491,640,3,1,0.915884078,173,134,35.23421589,20.9375,506,640,28,201
dog,yolov8x,2433596596_377bb91619_z.jpg,491,640,3,1,0.860069096,360,463,73.3197556,72.34375,64,527,125,485
dog,yolov8x,6113997729_5f5ac02209_z.jpg,480,640,3,1,0.957258224,338,317,70.41666667,49.53125,167,484,58,396
dog,yolov8x,2277306387_af18b2096e_z.jpg,483,640,3,1,0.966192484,442,436,91.51138716,68.125,144,580,2,444
dog,yolov8x,81717243_2c9fcf3dab_z.jpg,508,640,3,1,0.971385241,336,287,66.14173228,44.84375,208,495,128,464
dog,yolov8x,8343384446_ebe3bc86ce_z.jpg,640,617,3,1,0.960336566,527,298,82.34375,48.29821718,143,441,71,598
dog,yolov8x,2167290248_1ac3cbd890_z.jpg,639,485,3,1,0.977778256,594,416,92.95774648,85.77319588,7,423,45,639
dog,yolov8x,915541987_2627e91a14_z.jpg,640,431,3,1,0.971460819,505,430,78.90625,99.76798144,0,430,133,638
dog,yolov8x,5878631770_0c5592a1ee_z.jpg,427,640,3,1,0.968550026,323,534,75.6440281,83.4375,105,639,99,422
dog,yolov8x,3209962531_f75dbe4341_z.jpg,445,639,3,1,0.964298725,391,518,87.86516854,81.06416275,120,638,48,439
dog,yolov8x,16107639462_07e2d4455d_z.jpg,427,640,3,1,0.945394874,375,421,87.82201405,65.78125,128,549,45,420
dog,yolov8x,3291298501_9a8eed3fa0_z.jpg,427,640,3,1,0.966355145,365,502,85.48009368,78.4375,0,502,57,422
dog,yolov8x,34095624_ce7c705614_z.jpg,480,640,3,1,0.966980517,449,624,93.54166667,97.5,16,640,31,480
dog,yolov8x,4122228889_3b69997e0c_z.jpg,640,478,3,1,0.962841451,371,312,57.96875,65.27196653,71,383,151,522
dog,yolov8x,6897439523_236f77f06f_z.jpg,452,640,3,1,0.961880744,315,330,69.69026549,51.5625,50,380,43,358
dog,yolov8x,6897439523_236f77f06f_z.jpg,452,640,3,1,0.888096213,317,331,70.13274336,51.71875,110,441,40,357
dog,yolov8x,6897439523_236f77f06f_z.jpg,452,640,3,1,0.659870267,329,218,72.78761062,34.0625,398,616,107,436
dog,yolov8x,7248771448_66aab6455d_z.jpg,495,640,3,1,0.970456541,423,461,85.45454545,72.03125,56,517,36,459
dog,yolov8x,6238072987_89f2925563_z.jpg,640,480,3,1,0.975003123,562,396,87.8125,82.5,84,480,77,639
dog,yolov8x,84410494_ab268290cf_z.jpg,480,640,3,1,0.971363664,479,406,99.79166667,63.4375,150,556,0,479
dog,yolov8x,19030996840_1fbbb14eeb_z.jpg,640,640,3,1,0.973498106,386,402,60.3125,62.8125,1,403,254,640
dog,yolov8x,19030996840_1fbbb14eeb_z.jpg,640,640,3,1,0.966224253,540,498,84.375,77.8125,87,585,6,546
dog,yolov8x,5093076088_7bc77ec199_z.jpg,480,640,3,1,0.951741755,193,226,40.20833333,35.3125,119,345,134,327
dog,yolov8x,5093076088_7bc77ec199_z.jpg,480,640,3,1,0.948162913,160,150,33.33333333,23.4375,334,484,233,393
dog,yolov8x,387284206_360c4e3d6e_z.jpg,313,639,3,1,0.943160295,256,257,81.78913738,40.21909233,0,257,32,288
dog,yolov8x,387284206_360c4e3d6e_z.jpg,313,639,3,1,0.844990194,201,244,64.2172524,38.18466354,395,639,99,300
dog,yolov8x,387284206_360c4e3d6e_z.jpg,313,639,3,1,0.792032242,232,323,74.12140575,50.54773083,291,614,12,244
dog,yolov8x,387284206_360c4e3d6e_z.jpg,313,639,3,1,0.791887462,241,247,76.99680511,38.6541471,136,383,68,309
dog,yolov8x,677743874_168dcb5ed1_z.jpg,427,640,3,1,0.956293523,234,212,54.80093677,33.125,295,507,74,308
dog,yolov8x,677743874_168dcb5ed1_z.jpg,427,640,3,1,0.491784364,45,103,10.53864169,16.09375,297,400,53,98
dog,yolov8x,677743874_168dcb5ed1_z.jpg,427,640,3,1,0.268591642,45,162,10.53864169,25.3125,238,400,53,98
dog,yolov8x,3968015804_ac83717a19_z.jpg,427,640,3,1,0.973723352,376,388,88.05620609,60.625,124,512,46,422
dog,yolov8x,9031823026_3e55960d76_z.jpg,384,640,3,1,0.950209677,278,468,72.39583333,73.125,111,579,83,361
dog,yolov8x,7928462126_bb6f3a98bf_z.jpg,427,640,3,1,0.882499039,419,419,98.1264637,65.46875,56,475,0,419
dog,yolov8x,19309035192_8666b8c4e2_z.jpg,480,640,3,1,0.965863526,332,552,69.16666667,86.25,1,553,110,442
dog,yolov8x,14584923986_debd346d81_z.jpg,640,640,3,1,0.727699339,637,635,99.53125,99.21875,3,638,2,639
dog,yolov8x,5827517048_a890acd7e6_z.jpg,424,640,3,1,0.970454216,265,284,62.5,44.375,356,640,131,396
dog,yolov8x,5827517048_a890acd7e6_z.jpg,424,640,3,1,0.838362992,140,205,33.01886792,32.03125,305,510,80,220
dog,yolov8x,3850147043_06970bc680_z.jpg,480,640,3,1,0.96041882,239,430,49.79166667,67.1875,76,506,46,285
dog,yolov8x,506974894_b74672813b_z.jpg,427,640,3,1,0.931897461,288,467,67.44730679,72.96875,2,469,79,367
dog,yolov8x,506974894_b74672813b_z.jpg,427,640,3,1,0.501155972,112,361,26.2295082,56.40625,186,547,0,112
dog,yolov8x,4941417139_1608ab2596_z.jpg,480,640,3,1,0.876422405,387,630,80.625,98.4375,1,631,87,474
dog,yolov8x,361146297_ca9b5c8799_z.jpg,640,480,3,1,0.936810017,552,478,86.25,99.58333333,2,480,87,639
dog,yolov8x,19283436_772222a19e_z.jpg,472,640,3,1,0.925156713,370,205,78.38983051,32.03125,212,417,99,469
dog,yolov8x,5589760101_cf3ec6080e_z.jpg,424,640,3,1,0.959612072,417,473,98.3490566,73.90625,89,562,1,418
dog,yolov8x,20646999908_c3400d3ef6_z.jpg,480,640,3,1,0.954157472,437,620,91.04166667,96.875,4,624,43,480
dog,yolov8x,7443993440_80892cc39d_z.jpg,620,640,3,1,0.972426355,397,429,64.03225806,67.03125,101,530,121,518
dog,yolov8x,3812603979_2102c37672_z.jpg,426,640,3,1,0.9781757,394,528,92.48826291,82.5,98,626,27,421
dog,yolov8x,11709285374_bbb0e09e4e_z.jpg,477,640,3,1,0.976416707,383,421,80.29350105,65.78125,1,422,89,472
dog,yolov8x,11709285374_bbb0e09e4e_z.jpg,477,640,3,1,0.521707833,145,104,30.39832285,16.25,0,104,25,170
dog,yolov8x,2698863450_3a10857081_z.jpg,590,639,3,1,0.970088243,560,572,94.91525424,89.51486698,66,638,24,584
dog,yolov8x,241832541_43848dabf3_z.jpg,639,426,3,1,0.967542291,638,412,99.84350548,96.71361502,1,413,0,638
dog,yolov8x,14869105327_a74f23fa8a_z.jpg,600,639,3,1,0.974725544,529,387,88.16666667,60.56338028,94,481,0,529
dog,yolov8x,2814480856_385049d567_z.jpg,480,640,3,1,0.882859409,379,390,78.95833333,60.9375,149,539,0,379
dog,yolov8x,8132134109_24eaa95e21_z.jpg,359,639,3,1,0.95544374,346,324,96.37883008,50.70422535,147,471,1,347
dog,yolov8x,7283869010_60b2e311b5_z.jpg,587,639,3,1,0.97330904,326,365,55.53662692,57.12050078,156,521,190,516
dog,yolov8x,7283869010_60b2e311b5_z.jpg,587,639,3,1,0.752720952,88,104,14.99148211,16.27543036,438,542,260,348
dog,yolov8x,4163439575_7c6a260e8e_z.jpg,521,640,3,1,0.971307039,483,413,92.70633397,64.53125,50,463,26,509
dog,yolov8x,5290576324_881daf8265_z.jpg,480,640,3,1,0.911750019,175,123,36.45833333,19.21875,374,497,42,217
dog,yolov8x,5290576324_881daf8265_z.jpg,480,640,3,1,0.729738414,241,174,50.20833333,27.1875,105,279,166,407
dog,yolov8x,13472183804_b6c8633f6e_z.jpg,500,640,3,1,0.935123026,264,251,52.8,39.21875,233,484,155,419
dog,yolov8x,2296897953_08627d83a0_z.jpg,640,480,3,1,0.906474352,639,428,99.84375,89.16666667,1,429,0,639
dog,yolov8x,14351072751_334621d203_z.jpg,480,640,3,1,0.959666729,244,265,50.83333333,41.40625,162,427,47,291
dog,yolov8x,14351072751_334621d203_z.jpg,480,640,3,1,0.931531906,137,430,28.54166667,67.1875,159,589,247,384
dog,yolov8x,9159634981_ea2947ff02_z.jpg,640,480,3,1,0.925806224,546,450,85.3125,93.75,1,451,94,640
dog,yolov8x,9132297449_f27a6b1a45_z.jpg,612,612,3,1,0.962628424,519,390,84.80392157,63.7254902,83,473,27,546
dog,yolov8x,11381011104_36225e2ccc_z.jpg,543,640,3,1,0.972821057,510,638,93.92265193,99.6875,1,639,28,538
dog,yolov8x,239427670_897dedb1ea_z.jpg,425,640,3,1,0.881497622,417,529,98.11764706,82.65625,1,530,1,418
dog,yolov8x,4231227841_3821544fe1_z.jpg,608,640,3,1,0.952073038,434,232,71.38157895,36.25,205,437,158,592
dog,yolov8x,3462334590_2b8f39c540_z.jpg,548,639,3,1,0.915292561,123,115,22.44525547,17.99687011,328,443,344,467
dog,yolov8x,9201197273_a98cb719f5_z.jpg,480,640,3,1,0.975075185,479,395,99.79166667,61.71875,1,396,0,479
dog,yolov8x,5381237016_f49e86b880_z.jpg,383,640,3,1,0.957130551,291,271,75.97911227,42.34375,1,272,35,326
dog,yolov8x,2040136228_41c284c2cb_z.jpg,640,494,3,1,0.969247818,402,308,62.8125,62.34817814,68,376,83,485
dog,yolov8x,4444608672_0fa9174b62_z.jpg,427,640,3,1,0.937857985,421,528,98.59484778,82.5,0,528,0,421
dog,yolov8x,36110689_9cbbccb36a_z.jpg,496,640,3,1,0.93118912,469,590,94.55645161,92.1875,45,635,5,474
dog,yolov8x,13073061203_f7d640a8b3_z.jpg,428,639,3,1,0.94601649,198,379,46.26168224,59.3114241,1,380,85,283
dog,yolov8x,8730902798_bfe9360f4e_z.jpg,480,640,3,1,0.973071694,478,411,99.58333333,64.21875,228,639,1,479
dog,yolov8x,489195247_b908298ee6_z.jpg,480,640,3,1,0.951351583,417,300,86.875,46.875,193,493,62,479
dog,yolov8x,4018061968_3e03b2e96f_z.jpg,480,640,3,1,0.954630435,358,217,74.58333333,33.90625,221,438,61,419
dog,yolov8x,235979174_fcd7ef1374_z.jpg,640,480,3,1,0.972526491,535,301,83.59375,62.70833333,109,410,83,618
dog,yolov8x,15782459318_437c57f515_z.jpg,427,640,3,1,0.954301417,244,166,57.14285714,25.9375,367,533,182,426
dog,yolov8x,15782459318_437c57f515_z.jpg,427,640,3,1,0.953787744,264,164,61.82669789,25.625,120,284,159,423
dog,yolov8x,4975505027_db5864977d_z.jpg,480,640,3,1,0.953330636,253,171,52.70833333,26.71875,414,585,106,359
dog,yolov8x,4975505027_db5864977d_z.jpg,480,640,3,1,0.948051155,256,236,53.33333333,36.875,28,264,120,376
dog,yolov8x,4975505027_db5864977d_z.jpg,480,640,3,1,0.935441256,136,150,28.33333333,23.4375,336,486,224,360
dog,yolov8x,4975505027_db5864977d_z.jpg,480,640,3,1,0.90464747,136,153,28.33333333,23.90625,225,378,239,375
dog,yolov8x,4414731678_5f70c9f88e_z.jpg,480,640,3,1,0.955684304,285,413,59.375,64.53125,137,550,86,371
dog,yolov8x,1570552254_fcac0be216_z.jpg,428,640,3,1,0.903765261,125,124,29.20560748,19.375,132,256,303,428
dog,yolov8x,1570552254_fcac0be216_z.jpg,428,640,3,1,0.87376982,141,128,32.94392523,20,127,255,81,222
dog,yolov8x,1570552254_fcac0be216_z.jpg,428,640,3,1,0.863979876,111,126,25.93457944,19.6875,453,579,317,428
dog,yolov8x,1570552254_fcac0be216_z.jpg,428,640,3,1,0.863536537,128,119,29.90654206,18.59375,450,569,95,223
dog,yolov8x,7492624590_e473685314_z.jpg,626,640,3,1,0.938928306,577,561,92.17252396,87.65625,56,617,38,615
dog,yolov8x,5652496789_70e6f301e9_z.jpg,427,640,3,1,0.955558121,314,506,73.53629977,79.0625,54,560,108,422
dog,yolov8x,104222040_c20f16bbc0_z.jpg,480,640,3,0,0,0,0,0,0,0,0,0,0
dog,yolov8x,204668081_9bb000df17_z.jpg,550,640,3,1,0.970603406,376,385,68.36363636,60.15625,0,385,60,436
dog,yolov8x,7475018518_6c715a96c1_z.jpg,427,640,3,1,0.964001477,293,461,68.61826698,72.03125,52,513,75,368
dog,yolov8x,20843800936_edcdd89338_z.jpg,533,640,3,1,0.963769257,427,438,80.11257036,68.4375,100,538,71,498
dog,yolov8x,319365750_c6ecd7afbc_z.jpg,480,640,3,1,0.958246231,334,374,69.58333333,58.4375,190,564,55,389
dog,yolov8x,2177634493_51ca0597e2_z.jpg,640,640,3,1,0.907696426,624,638,97.5,99.6875,0,638,9,633
dog,yolov8x,8591221048_8fe555a40c_z.jpg,427,640,3,1,0.972199082,382,380,89.46135831,59.375,126,506,24,406
dog,yolov8x,2787764752_0277f5bbb2_z.jpg,480,640,3,1,0.955414951,310,470,64.58333333,73.4375,83,553,111,421
dog,yolov8x,2592416858_f849d2ac8f_z.jpg,480,640,3,1,0.959379137,442,289,92.08333333,45.15625,301,590,38,480
dog,yolov8x,2592416858_f849d2ac8f_z.jpg,480,640,3,1,0.950618029,277,181,57.70833333,28.28125,9,190,203,480
dog,yolov8x,2592416858_f849d2ac8f_z.jpg,480,640,3,1,0.858236194,345,171,71.875,26.71875,165,336,135,480
dog,yolov8x,3197300261_4e5e9c5e3e_z.jpg,640,640,3,1,0.962072909,536,414,83.75,64.6875,140,554,54,590
dog,yolov8x,16086668084_0d1665cda4_z.jpg,640,554,3,1,0.971677542,558,492,87.1875,88.80866426,4,496,81,639
dog,yolov8x,14409775264_5b589b56b4_z.jpg,480,640,3,1,0.977040529,413,395,86.04166667,61.71875,30,425,61,474
dog,yolov8x,4467873253_2ce7540d62_z.jpg,427,640,3,1,0.929866672,416,520,97.42388759,81.25,31,551,5,421
dog,yolov8x,105398161_799ded9b2a_z.jpg,640,480,3,1,0.948047876,448,402,70,83.75,73,475,95,543
dog,yolov8x,252889263_3cf2d57f34_z.jpg,480,640,3,1,0.926107347,417,247,86.875,38.59375,216,463,53,470
dog,yolov8x,252889263_3cf2d57f34_z.jpg,480,640,3,1,0.864164472,197,131,41.04166667,20.46875,0,131,282,479
dog,yolov8x,1134141407_0254c76c4d_z.jpg,384,640,3,1,0.934605539,341,355,88.80208333,55.46875,82,437,42,383
dog,yolov8x,3676100181_dc21ca177f_z.jpg,640,480,3,1,0.932874918,135,140,21.09375,29.16666667,121,261,387,522
person,yolov8l,6499183869_45bb8908c3_z.jpg,640,427,3,1,0.968464732,584,425,91.25,99.53161593,1,426,55,639
person,yolov8l,3409776362_07a8bb7f17_z.jpg,523,640,3,1,0.933552027,490,414,93.69024857,64.6875,87,501,26,516
person,yolov8l,8399932836_19c21d3779_z.jpg,640,524,3,1,0.972753167,575,420,89.84375,80.15267176,97,517,56,631
person,yolov8l,8349516772_6928ba8b88_z.jpg,480,640,3,1,0.958547413,434,505,90.41666667,78.90625,2,507,39,473
person,yolov8l,738798561_2d54b53ec5_z.jpg,640,480,3,1,0.952698112,581,426,90.78125,88.75,33,459,56,637
person,yolov8l,4282546783_10b5e0a62e_z.jpg,480,640,3,1,0.961146414,480,183,100,28.59375,0,183,0,480
person,yolov8l,4282546783_10b5e0a62e_z.jpg,480,640,3,1,0.912217081,395,145,82.29166667,22.65625,215,360,85,480
person,yolov8l,4282546783_10b5e0a62e_z.jpg,480,640,3,1,0.839940012,266,88,55.41666667,13.75,390,478,163,429
person,yolov8l,4282546783_10b5e0a62e_z.jpg,480,640,3,1,0.826456487,216,57,45,8.90625,449,506,189,405
person,yolov8l,4282546783_10b5e0a62e_z.jpg,480,640,3,1,0.711254478,196,107,40.83333333,16.71875,138,245,259,455
person,yolov8l,4282546783_10b5e0a62e_z.jpg,480,640,3,1,0.706137121,324,71,67.5,11.09375,332,403,130,454
person,yolov8l,4282546783_10b5e0a62e_z.jpg,480,640,3,1,0.645765603,138,43,28.75,6.71875,512,555,243,381
person,yolov8l,4282546783_10b5e0a62e_z.jpg,480,640,3,1,0.637291193,330,80,68.75,12.5,312,392,135,465
person,yolov8l,4282546783_10b5e0a62e_z.jpg,480,640,3,1,0.618967712,162,35,33.75,5.46875,488,523,221,383
person,yolov8l,4282546783_10b5e0a62e_z.jpg,480,640,3,1,0.533520401,112,43,23.33333333,6.71875,574,617,253,365
person,yolov8l,4282546783_10b5e0a62e_z.jpg,480,640,3,1,0.482428193,105,22,21.875,3.4375,606,628,255,360
person,yolov8l,4282546783_10b5e0a62e_z.jpg,480,640,3,1,0.472555578,128,31,26.66666667,4.84375,535,566,240,368
person,yolov8l,4282546783_10b5e0a62e_z.jpg,480,640,3,1,0.395253807,79,19,16.45833333,2.96875,621,640,276,355
person,yolov8l,4282546783_10b5e0a62e_z.jpg,480,640,3,1,0.303420395,29,27,6.041666667,4.21875,301,328,127,156
person,yolov8l,7166182137_a5679c9fa4_z.jpg,640,427,3,1,0.970819414,546,342,85.3125,80.09367681,13,355,93,639
person,yolov8l,4386974407_c2915fa9b1_z.jpg,639,457,3,1,0.938471258,416,174,65.10172144,38.07439825,141,315,95,511
person,yolov8l,6881088206_947a7622d4_z.jpg,640,480,3,1,0.943315566,468,283,73.125,58.95833333,137,420,92,560
person,yolov8l,6881088206_947a7622d4_z.jpg,640,480,3,1,0.812726259,339,131,52.96875,27.29166667,0,131,300,639
person,yolov8l,8874948232_195679aa4e_z.jpg,427,640,3,1,0.925262988,414,241,96.95550351,37.65625,288,529,7,421
person,yolov8l,8874948232_195679aa4e_z.jpg,427,640,3,1,0.918429792,322,202,75.40983607,31.5625,0,202,99,421
person,yolov8l,8874948232_195679aa4e_z.jpg,427,640,3,1,0.896346092,171,233,40.04683841,36.40625,179,412,252,423
person,yolov8l,8874948232_195679aa4e_z.jpg,427,640,3,1,0.891363323,204,177,47.77517564,27.65625,463,640,1,205
person,yolov8l,8874948232_195679aa4e_z.jpg,427,640,3,1,0.859827161,232,103,54.33255269,16.09375,467,570,116,348
person,yolov8l,8874948232_195679aa4e_z.jpg,427,640,3,1,0.851150751,138,88,32.31850117,13.75,552,640,162,300
person,yolov8l,8874948232_195679aa4e_z.jpg,427,640,3,1,0.796444535,140,198,32.78688525,30.9375,442,640,282,422
person,yolov8l,8874948232_195679aa4e_z.jpg,427,640,3,1,0.406702489,253,205,59.25058548,32.03125,107,312,72,325
person,yolov8l,8874948232_195679aa4e_z.jpg,427,640,3,1,0.304690897,160,40,37.470726,6.25,600,640,6,166
person,yolov8l,202416281_527efb7418_z.jpg,639,469,3,1,0.901837647,467,206,73.0829421,43.92324094,170,376,128,595
person,yolov8l,5605719660_5bed05cca3_z.jpg,425,640,3,1,0.962045312,418,403,98.35294118,62.96875,236,639,1,419
person,yolov8l,5605719660_5bed05cca3_z.jpg,425,640,3,1,0.955355942,405,249,95.29411765,38.90625,0,249,14,419
person,yolov8l,16850385890_8105762655_z.jpg,640,425,3,1,0.923146904,581,419,90.78125,98.58823529,5,424,57,638
person,yolov8l,16850385890_8105762655_z.jpg,640,425,3,1,0.65206486,568,129,88.75,30.35294118,0,129,69,637
person,yolov8l,98052295_1221189a77_z.jpg,534,640,3,1,0.879431784,525,537,98.31460674,83.90625,1,538,2,527
person,yolov8l,4030862073_d697f506b0_z.jpg,601,640,3,1,0.957870364,542,340,90.18302829,53.125,5,345,50,592
person,yolov8l,4030862073_d697f506b0_z.jpg,601,640,3,1,0.930372119,566,352,94.17637271,55,287,639,27,593
person,yolov8l,2768961204_712996d2bd_z.jpg,639,355,3,1,0.945668817,496,217,77.62128326,61.12676056,101,318,116,612
person,yolov8l,15983066535_629c335c63_z.jpg,427,640,3,1,0.97438544,401,462,93.91100703,72.1875,111,573,20,421
person,yolov8l,2946145533_75f5268f19_z.jpg,480,640,3,1,0.788932204,480,435,100,67.96875,1,436,0,480
person,yolov8l,8744937858_81c17befae_z.jpg,640,426,3,1,0.939158499,487,293,76.09375,68.77934272,71,364,62,549
person,yolov8l,8744937858_81c17befae_z.jpg,640,426,3,1,0.730186462,201,74,31.40625,17.37089202,352,426,44,245
person,yolov8l,8183126241_e78c7f86ba_z.jpg,425,640,3,1,0.957740843,414,324,97.41176471,50.625,7,331,5,419
person,yolov8l,8183126241_e78c7f86ba_z.jpg,425,640,3,1,0.94349432,377,292,88.70588235,45.625,289,581,42,419
person,yolov8l,8183126241_e78c7f86ba_z.jpg,425,640,3,1,0.700237811,199,63,46.82352941,9.84375,548,611,223,422
person,yolov8l,16954781749_4c32123444_z.jpg,427,640,3,1,0.943647563,335,211,78.45433255,32.96875,138,349,86,421
person,yolov8l,16954781749_4c32123444_z.jpg,427,640,3,1,0.936063945,328,202,76.81498829,31.5625,335,537,94,422
person,yolov8l,7581740758_a1c5cf246e_z.jpg,640,427,3,1,0.97685051,550,410,85.9375,96.01873536,0,410,89,639
person,yolov8l,5298850167_d1e13e9551_z.jpg,391,640,3,1,0.939579368,327,295,83.63171355,46.09375,0,295,58,385
person,yolov8l,5298850167_d1e13e9551_z.jpg,391,640,3,1,0.933653116,358,322,91.5601023,50.3125,318,640,28,386
person,yolov8l,5298850167_d1e13e9551_z.jpg,391,640,3,1,0.878350019,261,139,66.75191816,21.71875,0,139,51,312
person,yolov8l,5298850167_d1e13e9551_z.jpg,391,640,3,1,0.830134451,319,321,81.58567775,50.15625,156,477,66,385
person,yolov8l,4901520304_aa5c10705e_z.jpg,480,640,3,1,0.968373477,480,607,100,94.84375,4,611,0,480
person,yolov8l,4901520304_aa5c10705e_z.jpg,480,640,3,1,0.302633911,73,73,15.20833333,11.40625,0,73,164,237
person,yolov8l,14507981482_c50d893620_z.jpg,640,503,3,1,0.943020821,464,141,72.5,28.03180915,38,179,106,570
person,yolov8l,14507981482_c50d893620_z.jpg,640,503,3,1,0.925088406,529,185,82.65625,36.77932406,176,361,109,638
person,yolov8l,14507981482_c50d893620_z.jpg,640,503,3,1,0.888271928,440,125,68.75,24.85089463,134,259,68,508
person,yolov8l,14507981482_c50d893620_z.jpg,640,503,3,1,0.857103109,470,168,73.4375,33.39960239,305,473,94,564
person,yolov8l,14507981482_c50d893620_z.jpg,640,503,3,1,0.843488157,282,88,44.0625,17.49502982,363,451,338,620
person,yolov8l,14507981482_c50d893620_z.jpg,640,503,3,1,0.812019944,399,86,62.34375,17.09741551,402,488,53,452
person,yolov8l,14507981482_c50d893620_z.jpg,640,503,3,1,0.805603087,119,52,18.59375,10.33797217,317,369,69,188
person,yolov8l,14507981482_c50d893620_z.jpg,640,503,3,1,0.702840686,112,54,17.5,10.73558648,117,171,59,171
person,yolov8l,7742706992_27215ef7f8_z.jpg,640,428,3,1,0.938979089,527,327,82.34375,76.40186916,82,409,112,639
person,yolov8l,7742706992_27215ef7f8_z.jpg,640,428,3,1,0.911589622,340,181,53.125,42.28971963,233,414,44,384
person,yolov8l,7742706992_27215ef7f8_z.jpg,640,428,3,1,0.795871913,173,29,27.03125,6.775700935,398,427,166,339
person,yolov8l,7742706992_27215ef7f8_z.jpg,640,428,3,1,0.587745309,130,91,20.3125,21.26168224,0,91,510,640
person,yolov8l,11132512636_ebb3a6a070_z.jpg,427,640,3,1,0.885047913,366,171,85.71428571,26.71875,392,563,47,413
person,yolov8l,11132512636_ebb3a6a070_z.jpg,427,640,3,1,0.884503007,239,74,55.97189696,11.5625,320,394,146,385
person,yolov8l,11132512636_ebb3a6a070_z.jpg,427,640,3,1,0.83441186,304,131,71.19437939,20.46875,197,328,90,394
person,yolov8l,11132512636_ebb3a6a070_z.jpg,427,640,3,1,0.645736516,206,52,48.24355972,8.125,166,218,167,373
person,yolov8l,11132512636_ebb3a6a070_z.jpg,427,640,3,1,0.592513382,259,130,60.6557377,20.3125,61,191,121,380
person,yolov8l,7843905188_07e5d2a569_z.jpg,425,640,3,1,0.949279487,343,350,80.70588235,54.6875,1,351,76,419
person,yolov8l,7843905188_07e5d2a569_z.jpg,425,640,3,1,0.944999039,401,326,94.35294118,50.9375,313,639,18,419
person,yolov8l,189076128_ee6f694a30_z.jpg,640,428,3,1,0.963376462,577,425,90.15625,99.29906542,0,425,62,639
person,yolov8l,189076128_ee6f694a30_z.jpg,640,428,3,1,0.448061526,134,67,20.9375,15.65420561,361,428,504,638
person,yolov8l,6098643678_fc8044b5ac_z.jpg,427,640,3,1,0.958041549,366,260,85.71428571,40.625,380,640,55,421
person,yolov8l,6098643678_fc8044b5ac_z.jpg,427,640,3,1,0.915700257,319,243,74.70725995,37.96875,0,243,103,422
person,yolov8l,6098643678_fc8044b5ac_z.jpg,427,640,3,1,0.770177662,279,234,65.33957845,36.5625,233,467,143,422
person,yolov8l,2534669669_0c1d10c3e6_z.jpg,480,640,3,1,0.938888788,478,538,99.58333333,84.0625,0,538,1,479
person,yolov8l,5210291488_fe9939bdf1_z.jpg,360,640,3,1,0.913546026,163,66,45.27777778,10.3125,366,432,133,296
person,yolov8l,5210291488_fe9939bdf1_z.jpg,360,640,3,1,0.913518369,181,64,50.27777778,10,318,382,115,296
person,yolov8l,5210291488_fe9939bdf1_z.jpg,360,640,3,1,0.909770668,168,60,46.66666667,9.375,261,321,124,292
person,yolov8l,5210291488_fe9939bdf1_z.jpg,360,640,3,1,0.907274961,177,63,49.16666667,9.84375,150,213,112,289
person,yolov8l,5210291488_fe9939bdf1_z.jpg,360,640,3,1,0.896029234,164,77,45.55555556,12.03125,437,514,135,299
person,yolov8l,5210291488_fe9939bdf1_z.jpg,360,640,3,1,0.891502678,172,58,47.77777778,9.0625,207,265,116,288
person,yolov8l,5210291488_fe9939bdf1_z.jpg,360,640,3,1,0.890599072,159,55,44.16666667,8.59375,39,94,122,281
person,yolov8l,5210291488_fe9939bdf1_z.jpg,360,640,3,1,0.885081708,152,51,42.22222222,7.96875,94,145,133,285
person,yolov8l,5210291488_fe9939bdf1_z.jpg,360,640,3,1,0.882862091,105,52,29.16666667,8.125,518,570,152,257
person,yolov8l,5210291488_fe9939bdf1_z.jpg,360,640,3,1,0.747730017,116,91,32.22222222,14.21875,549,640,243,359
person,yolov8l,5210291488_fe9939bdf1_z.jpg,360,640,3,1,0.738276482,54,34,15,5.3125,260,294,105,159
person,yolov8l,5210291488_fe9939bdf1_z.jpg,360,640,3,1,0.614875257,147,36,40.83333333,5.625,87,123,116,263
person,yolov8l,5210291488_fe9939bdf1_z.jpg,360,640,3,1,0.413092732,180,159,50,24.84375,481,640,162,342
person,yolov8l,5210291488_fe9939bdf1_z.jpg,360,640,3,1,0.285380423,96,63,26.66666667,9.84375,577,640,162,258
person,yolov8l,4083309359_020d325f73_z.jpg,640,427,3,1,0.980160534,614,425,95.9375,99.53161593,1,426,25,639
person,yolov8l,8031274301_1d9bc9b665_z.jpg,640,427,3,1,0.938790977,564,335,88.125,78.45433255,0,335,75,639
person,yolov8l,8031274301_1d9bc9b665_z.jpg,640,427,3,1,0.905256271,639,184,99.84375,43.09133489,242,426,0,639
person,yolov8l,5481347426_620620145e_z.jpg,427,640,3,1,0.947116375,388,164,90.86651054,25.625,0,164,34,422
person,yolov8l,5481347426_620620145e_z.jpg,427,640,3,1,0.945559323,384,228,89.92974239,35.625,199,427,37,421
person,yolov8l,5481347426_620620145e_z.jpg,427,640,3,1,0.924813926,237,106,55.50351288,16.5625,515,621,187,424
person,yolov8l,5481347426_620620145e_z.jpg,427,640,3,1,0.873466492,249,85,58.31381733,13.28125,455,540,176,425
person,yolov8l,5481347426_620620145e_z.jpg,427,640,3,1,0.798556983,303,93,70.96018735,14.53125,197,290,120,423
person,yolov8l,5481347426_620620145e_z.jpg,427,640,3,1,0.676235497,276,58,64.63700234,9.0625,120,178,148,424
person,yolov8l,5481347426_620620145e_z.jpg,427,640,3,1,0.619841635,140,63,32.78688525,9.84375,389,452,235,375
person,yolov8l,5481347426_620620145e_z.jpg,427,640,3,1,0.498934686,140,21,32.78688525,3.28125,619,640,208,348
person,yolov8l,5481347426_620620145e_z.jpg,427,640,3,1,0.45545724,47,40,11.00702576,6.25,260,300,84,131
person,yolov8l,5481347426_620620145e_z.jpg,427,640,3,1,0.253499836,198,21,46.37002342,3.28125,619,640,209,407
person,yolov8l,5513074265_5b31a2339b_z.jpg,428,639,3,1,0.901155829,423,498,98.8317757,77.9342723,3,501,0,423
person,yolov8l,5513074265_5b31a2339b_z.jpg,428,639,3,1,0.737773895,420,279,98.13084112,43.66197183,1,280,1,421
person,yolov8l,10921149963_027e750820_z.jpg,425,640,3,1,0.923980176,330,209,77.64705882,32.65625,431,640,88,418
person,yolov8l,10921149963_027e750820_z.jpg,425,640,3,1,0.736686826,342,232,80.47058824,36.25,0,232,76,418
person,yolov8l,10921149963_027e750820_z.jpg,425,640,3,1,0.640156806,247,345,58.11764706,53.90625,198,543,126,373
person,yolov8l,268134569_0cea602ccb_z.jpg,480,640,3,1,0.95600009,456,374,95,58.4375,265,639,23,479
person,yolov8l,268134569_0cea602ccb_z.jpg,480,640,3,1,0.905353904,285,331,59.375,51.71875,0,331,195,480
person,yolov8l,268134569_0cea602ccb_z.jpg,480,640,3,1,0.805065453,479,322,99.79166667,50.3125,55,377,0,479
person,yolov8l,268134569_0cea602ccb_z.jpg,480,640,3,1,0.62896049,351,322,73.125,50.3125,318,640,0,351
person,yolov8l,7163490183_0dff14b5d6_z.jpg,360,640,3,1,0.902141929,349,271,96.94444444,42.34375,38,309,6,355
person,yolov8l,8488918795_f8ba7dabb6_z.jpg,594,471,3,1,0.94012475,493,145,82.996633,30.78556263,9,154,92,585
person,yolov8l,8488918795_f8ba7dabb6_z.jpg,594,471,3,1,0.933452189,472,133,79.46127946,28.23779193,299,432,94,566
person,yolov8l,8488918795_f8ba7dabb6_z.jpg,594,471,3,1,0.930203855,492,145,82.82828283,30.78556263,155,300,81,573
person,yolov8l,1444579876_8c02edf580_z.jpg,639,483,3,1,0.973349333,599,463,93.74021909,95.85921325,1,464,31,630
person,yolov8l,6111783458_61cc1f0f88_z.jpg,640,425,3,1,0.952003121,619,424,96.71875,99.76470588,0,424,19,638
person,yolov8l,10915137264_e8c23d54b4_z.jpg,639,428,3,1,0.953835905,487,318,76.21283255,74.29906542,45,363,151,638
person,yolov8l,4029738064_00c4cd038b_z.jpg,425,640,3,1,0.936332345,346,274,81.41176471,42.8125,48,322,74,420
person,yolov8l,6309741882_b074ee1a96_z.jpg,541,640,3,1,0.807279468,532,403,98.33641405,62.96875,236,639,0,532
person,yolov8l,6309741882_b074ee1a96_z.jpg,541,640,3,1,0.371915519,320,296,59.14972274,46.25,0,296,215,535
person,yolov8l,8572756223_94130c5e61_z.jpg,481,640,3,1,0.953986585,466,348,96.88149688,54.375,0,348,8,474
person,yolov8l,8572756223_94130c5e61_z.jpg,481,640,3,1,0.940362573,455,335,94.59459459,52.34375,304,639,18,473
person,yolov8l,16658372825_affc436763_z.jpg,640,369,3,1,0.883633435,409,170,63.90625,46.0704607,94,264,120,529
person,yolov8l,5298849761_aeeed1a3f9_z.jpg,640,425,3,1,0.954726398,626,424,97.8125,99.76470588,0,424,12,638
person,yolov8l,16433605163_8c9393beb1_z.jpg,480,640,3,1,0.948186219,234,158,48.75,24.6875,101,259,160,394
person,yolov8l,16433605163_8c9393beb1_z.jpg,480,640,3,1,0.906482697,161,178,33.54166667,27.8125,425,603,319,480
person,yolov8l,16433605163_8c9393beb1_z.jpg,480,640,3,1,0.836324036,174,67,36.25,10.46875,42,109,152,326
person,yolov8l,16433605163_8c9393beb1_z.jpg,480,640,3,1,0.809920251,217,64,45.20833333,10,330,394,159,376
person,yolov8l,16433605163_8c9393beb1_z.jpg,480,640,3,1,0.794805229,258,93,53.75,14.53125,441,534,159,417
person,yolov8l,16433605163_8c9393beb1_z.jpg,480,640,3,1,0.778087437,226,59,47.08333333,9.21875,411,470,163,389
person,yolov8l,16433605163_8c9393beb1_z.jpg,480,640,3,1,0.617094576,293,136,61.04166667,21.25,504,640,155,448
person,yolov8l,16433605163_8c9393beb1_z.jpg,480,640,3,1,0.541599393,134,46,27.91666667,7.1875,278,324,162,296
person,yolov8l,16433605163_8c9393beb1_z.jpg,480,640,3,1,0.323674411,149,65,31.04166667,10.15625,504,569,176,325
person,yolov8l,16433605163_8c9393beb1_z.jpg,480,640,3,1,0.317132264,154,55,32.08333333,8.59375,197,252,170,324
person,yolov8l,16433605163_8c9393beb1_z.jpg,480,640,3,1,0.313579857,141,71,29.375,11.09375,0,71,339,480
person,yolov8l,16433605163_8c9393beb1_z.jpg,480,640,3,1,0.300764233,43,17,8.958333333,2.65625,0,17,166,209
person,yolov8l,16433605163_8c9393beb1_z.jpg,480,640,3,1,0.282194883,46,32,9.583333333,5,447,479,162,208
person,yolov8l,15071673457_0703cea442_z.jpg,426,640,3,1,0.945799708,371,406,87.08920188,63.4375,100,506,49,420
person,yolov8l,300422857_eb3a885357_z.jpg,640,632,3,1,0.971550167,632,630,98.75,99.6835443,2,632,6,638
person,yolov8l,2522213440_edbcb5ba05_z.jpg,428,639,3,1,0.948965549,385,291,89.95327103,45.5399061,246,537,38,423
person,yolov8l,2522213440_edbcb5ba05_z.jpg,428,639,3,1,0.856431723,89,237,20.79439252,37.08920188,402,639,334,423
person,yolov8l,2522213440_edbcb5ba05_z.jpg,428,639,3,1,0.761051655,188,78,43.92523364,12.20657277,4,82,43,231
person,yolov8l,2522213440_edbcb5ba05_z.jpg,428,639,3,1,0.708855093,328,156,76.63551402,24.41314554,483,639,71,399
person,yolov8l,6985531639_71621c1e69_z.jpg,427,640,3,1,0.964568913,421,588,98.59484778,91.875,46,634,0,421
person,yolov8l,892497288_b916ec820e_z.jpg,481,640,3,1,0.826220751,391,366,81.28898129,57.1875,242,608,74,465
person,yolov8l,892497288_b916ec820e_z.jpg,481,640,3,1,0.735047817,63,56,13.0977131,8.75,0,56,21,84
person,yolov8l,892497288_b916ec820e_z.jpg,481,640,3,1,0.687164426,210,188,43.65904366,29.375,243,431,40,250
person,yolov8l,892497288_b916ec820e_z.jpg,481,640,3,1,0.664420187,355,313,73.8045738,48.90625,0,313,0,355
person,yolov8l,892497288_b916ec820e_z.jpg,481,640,3,1,0.610683382,169,361,35.13513514,56.40625,192,553,288,457
person,yolov8l,2767937261_724bce0179_z.jpg,480,640,3,1,0.964868128,401,303,83.54166667,47.34375,201,504,79,480
person,yolov8l,16104664631_cce4a9a58c_z.jpg,480,620,3,1,0.746064007,420,435,87.5,70.16129032,1,436,54,474
person,yolov8l,16104664631_cce4a9a58c_z.jpg,480,620,3,1,0.62933892,84,62,17.5,10,495,557,395,479
person,yolov8l,3954929491_6e95503c3d_z.jpg,420,640,3,1,0.631275594,200,115,47.61904762,17.96875,524,639,220,420
person,yolov8l,3954929491_6e95503c3d_z.jpg,420,640,3,1,0.553570747,190,100,45.23809524,15.625,191,291,229,419
person,yolov8l,3954929491_6e95503c3d_z.jpg,420,640,3,1,0.540729761,191,112,45.47619048,17.5,429,541,228,419
person,yolov8l,3954929491_6e95503c3d_z.jpg,420,640,3,1,0.50513649,207,93,49.28571429,14.53125,23,116,212,419
person,yolov8l,3954929491_6e95503c3d_z.jpg,420,640,3,1,0.471229225,196,94,46.66666667,14.6875,107,201,223,419
person,yolov8l,3954929491_6e95503c3d_z.jpg,420,640,3,1,0.424019724,179,76,42.61904762,11.875,278,354,240,419
person,yolov8l,3954929491_6e95503c3d_z.jpg,420,640,3,1,0.383970201,182,115,43.33333333,17.96875,336,451,238,420
person,yolov8l,3954929491_6e95503c3d_z.jpg,420,640,3,1,0.269022614,142,64,33.80952381,10,179,243,103,245
person,yolov8l,11983632613_4efcf5f3d3_z.jpg,402,640,3,1,0.950494289,167,400,41.54228856,62.5,240,640,193,360
person,yolov8l,11983632613_4efcf5f3d3_z.jpg,402,640,3,1,0.922583401,205,76,50.99502488,11.875,18,94,10,215
person,yolov8l,11983632613_4efcf5f3d3_z.jpg,402,640,3,1,0.868017137,123,48,30.59701493,7.5,1,49,50,173
person,yolov8l,11983632613_4efcf5f3d3_z.jpg,402,640,3,1,0.858413577,118,31,29.35323383,4.84375,128,159,47,165
person,yolov8l,11983632613_4efcf5f3d3_z.jpg,402,640,3,1,0.821757078,120,35,29.85074627,5.46875,80,115,49,169
person,yolov8l,11983632613_4efcf5f3d3_z.jpg,402,640,3,1,0.721700668,77,46,19.15422886,7.1875,298,344,46,123
person,yolov8l,11983632613_4efcf5f3d3_z.jpg,402,640,3,1,0.692195714,108,34,26.86567164,5.3125,344,378,21,129
person,yolov8l,11983632613_4efcf5f3d3_z.jpg,402,640,3,1,0.683194041,93,34,23.13432836,5.3125,476,510,33,126
person,yolov8l,11983632613_4efcf5f3d3_z.jpg,402,640,3,1,0.658330798,80,21,19.90049751,3.28125,262,283,64,144
person,yolov8l,11983632613_4efcf5f3d3_z.jpg,402,640,3,1,0.251965851,87,20,21.64179104,3.125,328,348,43,130
person,yolov8l,15625756039_d59f4e16fa_z.jpg,480,640,3,1,0.947131157,351,156,73.125,24.375,24,180,128,479
person,yolov8l,15625756039_d59f4e16fa_z.jpg,480,640,3,1,0.934964061,403,168,83.95833333,26.25,205,373,77,480
person,yolov8l,15625756039_d59f4e16fa_z.jpg,480,640,3,1,0.915950477,355,137,73.95833333,21.40625,424,561,125,480
person,yolov8l,15625756039_d59f4e16fa_z.jpg,480,640,3,1,0.874541998,398,96,82.91666667,15,361,457,81,479
person,yolov8l,6217890759_2a6a04d1d9_z.jpg,427,640,3,1,0.931562364,304,110,71.19437939,17.1875,457,567,95,399
person,yolov8l,6217890759_2a6a04d1d9_z.jpg,427,640,3,1,0.92881608,311,111,72.83372365,17.34375,60,171,102,413
person,yolov8l,6217890759_2a6a04d1d9_z.jpg,427,640,3,1,0.928213298,318,100,74.47306792,15.625,308,408,62,380
person,yolov8l,6217890759_2a6a04d1d9_z.jpg,427,640,3,1,0.918727458,280,96,65.57377049,15,151,247,94,374
person,yolov8l,6217890759_2a6a04d1d9_z.jpg,427,640,3,1,0.895788252,301,83,70.49180328,12.96875,234,317,70,371
person,yolov8l,6217890759_2a6a04d1d9_z.jpg,427,640,3,1,0.879977882,287,83,67.21311475,12.96875,387,470,95,382
person,yolov8l,3195432512_d0a96b2967_z.jpg,640,480,3,1,0.960356355,638,479,99.6875,99.79166667,0,479,0,638
person,yolov8l,16789366715_633121f7bb_z.jpg,640,457,3,1,0.967846453,637,391,99.53125,85.55798687,65,456,2,639
person,yolov8l,3442716929_7a26250063_z.jpg,640,427,3,1,0.969059467,586,426,91.5625,99.76580796,0,426,53,639
person,yolov8l,5943858783_a2cc450fb3_z.jpg,421,639,3,1,0.944504261,380,169,90.26128266,26.44757433,238,407,38,418
person,yolov8l,5943858783_a2cc450fb3_z.jpg,421,639,3,1,0.926138341,384,161,91.21140143,25.19561815,382,543,33,417
person,yolov8l,5943858783_a2cc450fb3_z.jpg,421,639,3,1,0.922714233,366,156,86.93586698,24.41314554,0,156,51,417
person,yolov8l,5943858783_a2cc450fb3_z.jpg,421,639,3,1,0.860420883,320,153,76.00950119,23.94366197,114,267,98,418
person,yolov8l,5425389979_390e3f3881_z.jpg,456,640,3,1,0.855359495,123,106,26.97368421,16.5625,130,236,275,398
person,yolov8l,5425389979_390e3f3881_z.jpg,456,640,3,1,0.746772587,108,104,23.68421053,16.25,329,433,292,400
person,yolov8l,5425389979_390e3f3881_z.jpg,456,640,3,1,0.680409372,106,94,23.24561404,14.6875,234,328,291,397
person,yolov8l,5425389979_390e3f3881_z.jpg,456,640,3,1,0.660950005,118,119,25.87719298,18.59375,13,132,292,410
person,yolov8l,5425389979_390e3f3881_z.jpg,456,640,3,1,0.656974733,123,96,26.97368421,15,431,527,280,403
person,yolov8l,5425389979_390e3f3881_z.jpg,456,640,3,1,0.640905678,112,101,24.56140351,15.78125,539,640,302,414
person,yolov8l,5425389979_390e3f3881_z.jpg,456,640,3,1,0.615898967,171,92,37.5,14.375,436,528,169,340
person,yolov8l,5425389979_390e3f3881_z.jpg,456,640,3,1,0.605654597,205,99,44.95614035,15.46875,509,608,178,383
person,yolov8l,5425389979_390e3f3881_z.jpg,456,640,3,1,0.568048179,211,100,46.27192982,15.625,12,112,170,381
person,yolov8l,5425389979_390e3f3881_z.jpg,456,640,3,1,0.552105606,179,93,39.25438596,14.53125,352,445,177,356
person,yolov8l,5425389979_390e3f3881_z.jpg,456,640,3,1,0.452890605,212,81,46.49122807,12.65625,189,270,161,373
person,yolov8l,5425389979_390e3f3881_z.jpg,456,640,3,1,0.441346526,174,95,38.15789474,14.84375,97,192,174,348
person,yolov8l,5425389979_390e3f3881_z.jpg,456,640,3,1,0.388172001,205,94,44.95614035,14.6875,266,360,151,356
person,yolov8l,5425389979_390e3f3881_z.jpg,456,640,3,1,0.296394497,139,79,30.48245614,12.34375,424,503,91,230
person,yolov8l,5387089136_efcdc42456_z.jpg,431,640,3,1,0.944216907,343,94,79.58236659,14.6875,0,94,49,392
person,yolov8l,5387089136_efcdc42456_z.jpg,431,640,3,1,0.935775638,375,98,87.00696056,15.3125,542,640,55,430
person,yolov8l,5387089136_efcdc42456_z.jpg,431,640,3,1,0.933840394,227,99,52.66821346,15.46875,239,338,198,425
person,yolov8l,5387089136_efcdc42456_z.jpg,431,640,3,1,0.926678836,231,103,53.5962877,16.09375,401,504,197,428
person,yolov8l,5387089136_efcdc42456_z.jpg,431,640,3,1,0.912715971,229,85,53.13225058,13.28125,171,256,195,424
person,yolov8l,5387089136_efcdc42456_z.jpg,431,640,3,1,0.91161418,244,97,56.612529,15.15625,495,592,185,429
person,yolov8l,5387089136_efcdc42456_z.jpg,431,640,3,1,0.907359719,264,99,61.25290023,15.46875,83,182,165,429
person,yolov8l,5387089136_efcdc42456_z.jpg,431,640,3,1,0.901504338,243,90,56.38051044,14.0625,331,421,187,430
person,yolov8l,5387089136_efcdc42456_z.jpg,431,640,3,1,0.883749902,86,78,19.95359629,12.1875,298,376,8,94
person,yolov8l,5387089136_efcdc42456_z.jpg,431,640,3,1,0.870640099,177,80,41.06728538,12.5,79,159,69,246
person,yolov8l,5387089136_efcdc42456_z.jpg,431,640,3,1,0.840063632,148,70,34.3387471,10.9375,516,586,42,190
person,yolov8l,5387089136_efcdc42456_z.jpg,431,640,3,1,0.824687779,58,85,13.45707657,13.28125,360,445,37,95
person,yolov8l,5387089136_efcdc42456_z.jpg,431,640,3,1,0.743332982,75,56,17.40139211,8.75,480,536,29,104
person,yolov8l,5387089136_efcdc42456_z.jpg,431,640,3,1,0.698277771,65,43,15.0812065,6.71875,50,93,69,134
person,yolov8l,5387089136_efcdc42456_z.jpg,431,640,3,1,0.673502028,64,69,14.84918794,10.78125,229,298,29,93
person,yolov8l,5387089136_efcdc42456_z.jpg,431,640,3,1,0.480165929,117,60,27.14617169,9.375,131,191,27,144
person,yolov8l,3300269400_c276d7a1a7_z.jpg,469,639,3,1,0.964087129,450,599,95.94882729,93.74021909,29,628,13,463
person,yolov8l,528252616_a57e6257ff_z.jpg,480,640,3,1,0.9095667,446,382,92.91666667,59.6875,208,590,34,480
person,yolov8l,528252616_a57e6257ff_z.jpg,480,640,3,1,0.894342422,330,168,68.75,26.25,0,168,150,480
person,yolov8l,528252616_a57e6257ff_z.jpg,480,640,3,1,0.81574887,338,219,70.41666667,34.21875,421,640,125,463
person,yolov8l,6723753569_a1d8678cde_z.jpg,640,425,3,1,0.962296188,603,422,94.21875,99.29411765,2,424,35,638
person,yolov8l,201365540_d1af73d7cd_z.jpg,640,482,3,1,0.896137416,624,479,97.5,99.37759336,2,481,15,639
person,yolov8l,15091650494_d8a5f37637_z.jpg,640,427,3,1,0.982394099,581,426,90.78125,99.76580796,0,426,58,639
person,yolov8l,2365652301_0de626bd97_z.jpg,498,640,3,1,0.926662147,353,124,70.88353414,19.375,390,514,72,425
person,yolov8l,2365652301_0de626bd97_z.jpg,498,640,3,1,0.894849658,312,143,62.65060241,22.34375,226,369,116,428
person,yolov8l,8960442702_6c931904f0_z.jpg,427,640,3,1,0.94117111,422,228,98.82903981,35.625,266,494,0,422
person,yolov8l,8960442702_6c931904f0_z.jpg,427,640,3,1,0.937523127,420,181,98.36065574,28.28125,85,266,1,421
person,yolov8l,5594762666_e157f338f0_z.jpg,425,640,3,1,0.962673187,394,293,92.70588235,45.78125,347,640,25,419
person,yolov8l,5594762666_e157f338f0_z.jpg,425,640,3,1,0.927066028,370,324,87.05882353,50.625,0,324,50,420
person,yolov8l,7192116992_5447de0caa_z.jpg,640,480,3,1,0.982453227,616,478,96.25,99.58333333,0,478,21,637
person,yolov8l,8562326627_1a68052e58_z.jpg,640,582,3,1,0.542499244,516,429,80.625,73.71134021,152,581,123,639
person,yolov8l,4380790081_1cbcb573ec_z.jpg,421,640,3,1,0.97815448,376,609,89.3111639,95.15625,12,621,39,415
person,yolov8l,15392489891_905432249f_z.jpg,427,640,3,1,0.953724742,293,190,68.61826698,29.6875,63,253,0,293
person,yolov8l,15392489891_905432249f_z.jpg,427,640,3,1,0.93347168,244,186,57.14285714,29.0625,337,523,179,423
person,yolov8l,15392489891_905432249f_z.jpg,427,640,3,1,0.901858211,256,229,59.95316159,35.78125,124,353,161,417
person,yolov8l,15392489891_905432249f_z.jpg,427,640,3,1,0.801825464,55,45,12.88056206,7.03125,242,287,133,188
person,yolov8l,15392489891_905432249f_z.jpg,427,640,3,1,0.572189629,104,114,24.3559719,17.8125,350,464,147,251
person,yolov8l,15392489891_905432249f_z.jpg,427,640,3,1,0.378120512,111,58,25.99531616,9.0625,242,300,132,243
person,yolov8l,15392489891_905432249f_z.jpg,427,640,3,1,0.265812814,103,81,24.12177986,12.65625,349,430,147,250
person,yolov8l,4479906928_4ab0604d1c_z.jpg,640,480,3,1,0.943288267,637,345,99.53125,71.875,40,385,2,639
person,yolov8l,2392419690_8495e2b2c9_z.jpg,496,640,3,1,0.952372015,240,188,48.38709677,29.375,3,191,252,492
person,yolov8l,2392419690_8495e2b2c9_z.jpg,496,640,3,1,0.952119946,243,197,48.99193548,30.78125,323,520,2,245
person,yolov8l,2392419690_8495e2b2c9_z.jpg,496,640,3,1,0.934474111,241,257,48.58870968,40.15625,3,260,3,244
person,yolov8l,2392419690_8495e2b2c9_z.jpg,496,640,3,1,0.922947884,241,165,48.58870968,25.78125,323,488,251,492
person,yolov8l,2392419690_8495e2b2c9_z.jpg,496,640,3,1,0.909665406,169,217,34.07258065,33.90625,420,637,324,493
person,yolov8l,2392419690_8495e2b2c9_z.jpg,496,640,3,1,0.851775229,78,61,15.72580645,9.53125,16,77,251,329
person,yolov8l,2392419690_8495e2b2c9_z.jpg,496,640,3,1,0.821077108,118,157,23.79032258,24.53125,420,577,128,246
person,yolov8l,2392419690_8495e2b2c9_z.jpg,496,640,3,1,0.587117434,98,160,19.75806452,25,103,263,396,494
person,yolov8l,8538565946_199e28b584_z.jpg,612,612,3,1,0.942414641,601,518,98.20261438,84.64052288,65,583,9,610
person,yolov8l,15083791924_c7195faca3_z.jpg,428,640,3,1,0.967883646,422,398,98.59813084,62.1875,51,449,1,423
person,yolov8l,8922688952_9cacbffe29_z.jpg,639,402,3,1,0.8725425,628,400,98.27856025,99.50248756,2,402,10,638
person,yolov8l,8922688952_9cacbffe29_z.jpg,639,402,3,1,0.798208058,636,253,99.53051643,62.93532338,0,253,0,636
person,yolov8l,5540859766_5596c9c59e_z.jpg,520,600,3,1,0.973766625,482,576,92.69230769,96,0,576,32,514
person,yolov8l,5826499075_8c91ec270b_z.jpg,640,478,3,1,0.535553575,525,320,82.03125,66.94560669,60,380,114,639
person,yolov8l,4728907141_f9e5aa4bce_z.jpg,480,640,3,1,0.943025708,324,207,67.5,32.34375,185,392,57,381
person,yolov8l,4728907141_f9e5aa4bce_z.jpg,480,640,3,1,0.920310616,182,106,37.91666667,16.5625,0,106,23,205
person,yolov8l,4728907141_f9e5aa4bce_z.jpg,480,640,3,1,0.849644721,177,97,36.875,15.15625,490,587,18,195
person,yolov8l,4728907141_f9e5aa4bce_z.jpg,480,640,3,1,0.494419664,41,99,8.541666667,15.46875,301,400,0,41
person,yolov8l,5316877862_ccdebd50e5_z.jpg,419,639,3,1,0.948574424,361,351,86.1575179,54.92957746,287,638,55,416
person,yolov8l,5316877862_ccdebd50e5_z.jpg,419,639,3,1,0.918406844,380,227,90.69212411,35.52425665,13,240,34,414
person,yolov8l,5316877862_ccdebd50e5_z.jpg,419,639,3,1,0.884269834,413,88,98.56801909,13.771518,0,88,0,413
person,yolov8l,5316877862_ccdebd50e5_z.jpg,419,639,3,1,0.785725772,60,51,14.31980907,7.981220657,298,349,359,419
person,yolov8l,5316877862_ccdebd50e5_z.jpg,419,639,3,1,0.599820554,230,35,54.89260143,5.477308294,242,277,188,418
person,yolov8l,5316877862_ccdebd50e5_z.jpg,419,639,3,1,0.504954815,266,69,63.48448687,10.79812207,192,261,94,360
person,yolov8l,5316877862_ccdebd50e5_z.jpg,419,639,3,1,0.492219359,38,27,9.069212411,4.225352113,278,305,381,419
person,yolov8l,15543230406_71c5a59208_z.jpg,463,640,3,1,0.926870167,365,245,78.8336933,38.28125,227,472,92,457
person,yolov8l,15543230406_71c5a59208_z.jpg,463,640,3,1,0.907279193,364,392,78.61771058,61.25,246,638,93,457
person,yolov8l,15543230406_71c5a59208_z.jpg,463,640,3,1,0.897333741,434,284,93.73650108,44.375,1,285,23,457
person,yolov8l,6431185703_6c72dd7b5e_z.jpg,427,640,3,1,0.819518149,136,48,31.8501171,7.5,212,260,184,320
person,yolov8l,6431185703_6c72dd7b5e_z.jpg,427,640,3,1,0.700579226,119,42,27.86885246,6.5625,155,197,188,307
person,yolov8l,6431185703_6c72dd7b5e_z.jpg,427,640,3,1,0.696885705,99,35,23.18501171,5.46875,88,123,192,291
person,yolov8l,6431185703_6c72dd7b5e_z.jpg,427,640,3,1,0.682853341,113,38,26.46370023,5.9375,118,156,189,302
person,yolov8l,6431185703_6c72dd7b5e_z.jpg,427,640,3,1,0.666634619,159,66,37.23653396,10.3125,427,493,179,338
person,yolov8l,6431185703_6c72dd7b5e_z.jpg,427,640,3,1,0.612977386,149,52,34.89461358,8.125,487,539,170,319
person,yolov8l,6431185703_6c72dd7b5e_z.jpg,427,640,3,1,0.60453707,153,62,35.83138173,9.6875,285,347,188,341
person,yolov8l,6431185703_6c72dd7b5e_z.jpg,427,640,3,1,0.595552742,91,29,21.31147541,4.53125,62,91,194,285
person,yolov8l,6431185703_6c72dd7b5e_z.jpg,427,640,3,1,0.559440315,134,67,31.38173302,10.46875,551,618,169,303
person,yolov8l,6431185703_6c72dd7b5e_z.jpg,427,640,3,1,0.483291924,74,27,17.33021077,4.21875,42,69,207,281
person,yolov8l,6431185703_6c72dd7b5e_z.jpg,427,640,3,1,0.457464546,154,75,36.06557377,11.71875,341,416,201,355
person,yolov8l,6431185703_6c72dd7b5e_z.jpg,427,640,3,1,0.408731043,100,30,23.41920375,4.6875,186,216,188,288
person,yolov8l,6431185703_6c72dd7b5e_z.jpg,427,640,3,1,0.252811342,128,47,29.9765808,7.34375,396,443,176,304
person,yolov8m,6499183869_45bb8908c3_z.jpg,640,427,3,1,0.973787546,581,425,90.78125,99.53161593,0,425,57,638
person,yolov8m,3409776362_07a8bb7f17_z.jpg,523,640,3,1,0.911449552,492,416,94.07265774,65,87,503,25,517
person,yolov8m,8399932836_19c21d3779_z.jpg,640,524,3,1,0.965584517,576,420,90,80.15267176,97,517,57,633
person,yolov8m,8349516772_6928ba8b88_z.jpg,480,640,3,1,0.937038004,435,507,90.625,79.21875,1,508,38,473
person,yolov8m,738798561_2d54b53ec5_z.jpg,640,480,3,1,0.954792798,581,427,90.78125,88.95833333,36,463,57,638
person,yolov8m,4282546783_10b5e0a62e_z.jpg,480,640,3,1,0.966669261,477,184,99.375,28.75,0,184,2,479
person,yolov8m,4282546783_10b5e0a62e_z.jpg,480,640,3,1,0.912094295,394,148,82.08333333,23.125,213,361,85,479
person,yolov8m,4282546783_10b5e0a62e_z.jpg,480,640,3,1,0.873190701,196,109,40.83333333,17.03125,138,247,260,456
person,yolov8m,4282546783_10b5e0a62e_z.jpg,480,640,3,1,0.861491024,267,88,55.625,13.75,389,477,161,428
person,yolov8m,4282546783_10b5e0a62e_z.jpg,480,640,3,1,0.666561902,314,79,65.41666667,12.34375,312,391,150,464
person,yolov8m,4282546783_10b5e0a62e_z.jpg,480,640,3,1,0.576001406,214,58,44.58333333,9.0625,449,507,189,403
person,yolov8m,4282546783_10b5e0a62e_z.jpg,480,640,3,1,0.557688177,138,40,28.75,6.25,517,557,243,381
person,yolov8m,4282546783_10b5e0a62e_z.jpg,480,640,3,1,0.396827817,112,42,23.33333333,6.5625,574,616,252,364
person,yolov8m,4282546783_10b5e0a62e_z.jpg,480,640,3,1,0.396762043,124,30,25.83333333,4.6875,536,566,240,364
person,yolov8m,4282546783_10b5e0a62e_z.jpg,480,640,3,1,0.385830253,329,78,68.54166667,12.1875,326,404,130,459
person,yolov8m,4282546783_10b5e0a62e_z.jpg,480,640,3,1,0.361273468,81,19,16.875,2.96875,621,640,274,355
person,yolov8m,4282546783_10b5e0a62e_z.jpg,480,640,3,1,0.32005927,105,22,21.875,3.4375,607,629,254,359
person,yolov8m,4282546783_10b5e0a62e_z.jpg,480,640,3,1,0.25448367,161,35,33.54166667,5.46875,489,524,220,381
person,yolov8m,7166182137_a5679c9fa4_z.jpg,640,427,3,1,0.965826869,545,340,85.15625,79.62529274,14,354,94,639
person,yolov8m,4386974407_c2915fa9b1_z.jpg,639,457,3,1,0.945778191,416,174,65.10172144,38.07439825,141,315,96,512
person,yolov8m,6881088206_947a7622d4_z.jpg,640,480,3,1,0.942887485,468,282,73.125,58.75,139,421,92,560
person,yolov8m,6881088206_947a7622d4_z.jpg,640,480,3,1,0.913028598,324,128,50.625,26.66666667,1,129,315,639
person,yolov8m,8874948232_195679aa4e_z.jpg,427,640,3,1,0.943557024,414,237,96.95550351,37.03125,290,527,8,422
person,yolov8m,8874948232_195679aa4e_z.jpg,427,640,3,1,0.938850105,323,203,75.6440281,31.71875,0,203,98,421
person,yolov8m,8874948232_195679aa4e_z.jpg,427,640,3,1,0.903636754,175,233,40.98360656,36.40625,179,412,248,423
person,yolov8m,8874948232_195679aa4e_z.jpg,427,640,3,1,0.858277678,136,88,31.8501171,13.75,552,640,161,297
person,yolov8m,8874948232_195679aa4e_z.jpg,427,640,3,1,0.853741348,142,201,33.25526932,31.40625,439,640,281,423
person,yolov8m,8874948232_195679aa4e_z.jpg,427,640,3,1,0.830909312,229,103,53.62997658,16.09375,467,570,115,344
person,yolov8m,8874948232_195679aa4e_z.jpg,427,640,3,1,0.817168117,204,178,47.77517564,27.8125,461,639,0,204
person,yolov8m,8874948232_195679aa4e_z.jpg,427,640,3,1,0.624539077,277,305,64.87119438,47.65625,6,311,74,351
person,yolov8m,8874948232_195679aa4e_z.jpg,427,640,3,1,0.456319362,154,40,36.06557377,6.25,600,640,12,166
person,yolov8m,202416281_527efb7418_z.jpg,639,469,3,1,0.900157213,469,213,73.39593114,45.41577825,169,382,127,596
person,yolov8m,5605719660_5bed05cca3_z.jpg,425,640,3,1,0.962990046,418,403,98.35294118,62.96875,236,639,1,419
person,yolov8m,5605719660_5bed05cca3_z.jpg,425,640,3,1,0.951740563,405,248,95.29411765,38.75,1,249,13,418
person,yolov8m,16850385890_8105762655_z.jpg,640,425,3,1,0.892774343,581,407,90.78125,95.76470588,17,424,56,637
person,yolov8m,16850385890_8105762655_z.jpg,640,425,3,1,0.532240927,424,141,66.25,33.17647059,0,141,213,637
person,yolov8m,98052295_1221189a77_z.jpg,534,640,3,1,0.94422543,528,635,98.87640449,99.21875,2,637,2,530
person,yolov8m,98052295_1221189a77_z.jpg,534,640,3,1,0.314108133,426,145,79.7752809,22.65625,491,636,76,502
person,yolov8m,4030862073_d697f506b0_z.jpg,601,640,3,1,0.949463308,541,345,90.01663894,53.90625,3,348,51,592
person,yolov8m,4030862073_d697f506b0_z.jpg,601,640,3,1,0.916267753,563,361,93.67720466,56.40625,278,639,28,591
person,yolov8m,2768961204_712996d2bd_z.jpg,639,355,3,1,0.938524604,498,215,77.9342723,60.56338028,101,316,116,614
person,yolov8m,15983066535_629c335c63_z.jpg,427,640,3,1,0.964265347,402,460,94.14519906,71.875,112,572,19,421
person,yolov8m,2946145533_75f5268f19_z.jpg,480,640,3,1,0.621691346,478,629,99.58333333,98.28125,3,632,1,479
person,yolov8m,8744937858_81c17befae_z.jpg,640,426,3,1,0.939134002,486,295,75.9375,69.24882629,71,366,61,547
person,yolov8m,8183126241_e78c7f86ba_z.jpg,425,640,3,1,0.961403072,415,323,97.64705882,50.46875,7,330,4,419
person,yolov8m,8183126241_e78c7f86ba_z.jpg,425,640,3,1,0.95402205,377,292,88.70588235,45.625,288,580,42,419
person,yolov8m,8183126241_e78c7f86ba_z.jpg,425,640,3,1,0.757510006,198,65,46.58823529,10.15625,547,612,223,421
person,yolov8m,16954781749_4c32123444_z.jpg,427,640,3,1,0.945630193,335,211,78.45433255,32.96875,138,349,86,421
person,yolov8m,16954781749_4c32123444_z.jpg,427,640,3,1,0.939861298,328,201,76.81498829,31.40625,336,537,93,421
person,yolov8m,7581740758_a1c5cf246e_z.jpg,640,427,3,1,0.970387161,550,408,85.9375,95.55035129,0,408,88,638
person,yolov8m,5298850167_d1e13e9551_z.jpg,391,640,3,1,0.933970392,354,324,90.5370844,50.625,316,640,31,385
person,yolov8m,5298850167_d1e13e9551_z.jpg,391,640,3,1,0.912917316,330,301,84.39897698,47.03125,1,302,56,386
person,yolov8m,5298850167_d1e13e9551_z.jpg,391,640,3,1,0.853903651,261,134,66.75191816,20.9375,0,134,52,313
person,yolov8m,5298850167_d1e13e9551_z.jpg,391,640,3,1,0.794861734,322,333,82.35294118,52.03125,144,477,65,387
person,yolov8m,4901520304_aa5c10705e_z.jpg,480,640,3,1,0.945063412,476,607,99.16666667,94.84375,2,609,3,479
person,yolov8m,4901520304_aa5c10705e_z.jpg,480,640,3,1,0.409556001,69,75,14.375,11.71875,0,75,167,236
person,yolov8m,14507981482_c50d893620_z.jpg,640,503,3,1,0.930767775,462,141,72.1875,28.03180915,37,178,106,568
person,yolov8m,14507981482_c50d893620_z.jpg,640,503,3,1,0.901137412,529,183,82.65625,36.38170974,177,360,107,636
person,yolov8m,14507981482_c50d893620_z.jpg,640,503,3,1,0.872654676,396,123,61.875,24.45328032,136,259,67,463
person,yolov8m,14507981482_c50d893620_z.jpg,640,503,3,1,0.866574526,399,83,62.34375,16.50099404,405,488,52,451
person,yolov8m,14507981482_c50d893620_z.jpg,640,503,3,1,0.842582583,280,87,43.75,17.29622266,364,451,338,618
person,yolov8m,14507981482_c50d893620_z.jpg,640,503,3,1,0.789744377,468,170,73.125,33.7972167,307,477,94,562
person,yolov8m,14507981482_c50d893620_z.jpg,640,503,3,1,0.751360774,116,48,18.125,9.542743539,320,368,69,185
person,yolov8m,14507981482_c50d893620_z.jpg,640,503,3,1,0.722087979,109,57,17.03125,11.33200795,117,174,60,169
person,yolov8m,7742706992_27215ef7f8_z.jpg,640,428,3,1,0.923993111,528,322,82.5,75.23364486,83,405,110,638
person,yolov8m,7742706992_27215ef7f8_z.jpg,640,428,3,1,0.877382994,341,182,53.28125,42.52336449,233,415,43,384
person,yolov8m,7742706992_27215ef7f8_z.jpg,640,428,3,1,0.721722007,129,89,20.15625,20.79439252,0,89,510,639
person,yolov8m,7742706992_27215ef7f8_z.jpg,640,428,3,1,0.645580471,170,30,26.5625,7.009345794,397,427,167,337
person,yolov8m,11132512636_ebb3a6a070_z.jpg,427,640,3,1,0.872723997,304,128,71.19437939,20,200,328,89,393
person,yolov8m,11132512636_ebb3a6a070_z.jpg,427,640,3,1,0.827939689,260,126,60.88992974,19.6875,61,187,121,381
person,yolov8m,11132512636_ebb3a6a070_z.jpg,427,640,3,1,0.792797565,240,76,56.20608899,11.875,319,395,147,387
person,yolov8m,11132512636_ebb3a6a070_z.jpg,427,640,3,1,0.767097592,364,170,85.24590164,26.5625,393,563,48,412
person,yolov8m,11132512636_ebb3a6a070_z.jpg,427,640,3,1,0.673533738,205,51,48.00936768,7.96875,167,218,169,374
person,yolov8m,7843905188_07e5d2a569_z.jpg,425,640,3,1,0.946199358,399,328,93.88235294,51.25,311,639,19,418
person,yolov8m,7843905188_07e5d2a569_z.jpg,425,640,3,1,0.939129174,344,349,80.94117647,54.53125,1,350,75,419
person,yolov8m,189076128_ee6f694a30_z.jpg,640,428,3,1,0.929319978,582,426,90.9375,99.53271028,1,427,57,639
person,yolov8m,189076128_ee6f694a30_z.jpg,640,428,3,1,0.253239065,128,67,20,15.65420561,361,428,511,639
person,yolov8m,6098643678_fc8044b5ac_z.jpg,427,640,3,1,0.957489789,366,259,85.71428571,40.46875,380,639,55,421
person,yolov8m,6098643678_fc8044b5ac_z.jpg,427,640,3,1,0.864402235,278,225,65.10538642,35.15625,241,466,143,421
person,yolov8m,6098643678_fc8044b5ac_z.jpg,427,640,3,1,0.853922129,319,251,74.70725995,39.21875,0,251,103,422
person,yolov8m,2534669669_0c1d10c3e6_z.jpg,480,640,3,1,0.921449602,478,534,99.58333333,83.4375,1,535,1,479
person,yolov8m,5210291488_fe9939bdf1_z.jpg,360,640,3,1,0.888260543,165,74,45.83333333,11.5625,437,511,134,299
person,yolov8m,5210291488_fe9939bdf1_z.jpg,360,640,3,1,0.885163784,181,65,50.27777778,10.15625,317,382,114,295
person,yolov8m,5210291488_fe9939bdf1_z.jpg,360,640,3,1,0.8843624,176,61,48.88888889,9.53125,150,211,112,288
person,yolov8m,5210291488_fe9939bdf1_z.jpg,360,640,3,1,0.874480128,169,60,46.94444444,9.375,261,321,123,292
person,yolov8m,5210291488_fe9939bdf1_z.jpg,360,640,3,1,0.872323275,171,60,47.5,9.375,205,265,117,288
person,yolov8m,5210291488_fe9939bdf1_z.jpg,360,640,3,1,0.868684292,163,65,45.27777778,10.15625,367,432,133,296
person,yolov8m,5210291488_fe9939bdf1_z.jpg,360,640,3,1,0.857539535,159,55,44.16666667,8.59375,39,94,122,281
person,yolov8m,5210291488_fe9939bdf1_z.jpg,360,640,3,1,0.85694778,105,53,29.16666667,8.28125,517,570,152,257
person,yolov8m,5210291488_fe9939bdf1_z.jpg,360,640,3,1,0.810829937,154,51,42.77777778,7.96875,94,145,132,286
person,yolov8m,5210291488_fe9939bdf1_z.jpg,360,640,3,1,0.655423522,54,34,15,5.3125,261,295,105,159
person,yolov8m,5210291488_fe9939bdf1_z.jpg,360,640,3,1,0.469992697,179,157,49.72222222,24.53125,481,638,163,342
person,yolov8m,5210291488_fe9939bdf1_z.jpg,360,640,3,1,0.374018431,35,90,9.722222222,14.0625,550,640,324,359
person,yolov8m,5210291488_fe9939bdf1_z.jpg,360,640,3,1,0.332337171,154,35,42.77777778,5.46875,80,115,112,266
person,yolov8m,5210291488_fe9939bdf1_z.jpg,360,640,3,1,0.278313488,166,64,46.11111111,10,576,640,162,328
person,yolov8m,4083309359_020d325f73_z.jpg,640,427,3,1,0.974983275,607,426,94.84375,99.76580796,0,426,32,639
person,yolov8m,8031274301_1d9bc9b665_z.jpg,640,427,3,1,0.929287553,564,321,88.125,75.17564403,0,321,75,639
person,yolov8m,8031274301_1d9bc9b665_z.jpg,640,427,3,1,0.856078744,637,184,99.53125,43.09133489,242,426,1,638
person,yolov8m,5481347426_620620145e_z.jpg,427,640,3,1,0.952946484,389,163,91.10070258,25.46875,0,163,34,423
person,yolov8m,5481347426_620620145e_z.jpg,427,640,3,1,0.941107333,384,228,89.92974239,35.625,199,427,38,422
person,yolov8m,5481347426_620620145e_z.jpg,427,640,3,1,0.918615639,236,106,55.26932084,16.5625,515,621,188,424
person,yolov8m,5481347426_620620145e_z.jpg,427,640,3,1,0.905827463,249,83,58.31381733,12.96875,455,538,175,424
person,yolov8m,5481347426_620620145e_z.jpg,427,640,3,1,0.73022151,272,61,63.70023419,9.53125,114,175,153,425
person,yolov8m,5481347426_620620145e_z.jpg,427,640,3,1,0.723909676,304,92,71.19437939,14.375,199,291,118,422
person,yolov8m,5481347426_620620145e_z.jpg,427,640,3,1,0.552967846,199,24,46.60421546,3.75,616,640,216,415
person,yolov8m,5481347426_620620145e_z.jpg,427,640,3,1,0.524623811,135,61,31.61592506,9.53125,389,450,237,372
person,yolov8m,5481347426_620620145e_z.jpg,427,640,3,1,0.473028302,51,41,11.94379391,6.40625,260,301,84,135
person,yolov8m,5481347426_620620145e_z.jpg,427,640,3,1,0.355687797,112,86,26.2295082,13.4375,202,288,121,233
person,yolov8m,5481347426_620620145e_z.jpg,427,640,3,1,0.312604934,130,41,30.44496487,6.40625,172,213,222,352
person,yolov8m,5481347426_620620145e_z.jpg,427,640,3,1,0.283877373,200,34,46.83840749,5.3125,606,640,216,416
person,yolov8m,5513074265_5b31a2339b_z.jpg,428,639,3,1,0.861565113,424,485,99.06542056,75.89984351,13,498,0,424
person,yolov8m,5513074265_5b31a2339b_z.jpg,428,639,3,1,0.828490198,423,282,98.8317757,44.1314554,2,284,0,423
person,yolov8m,10921149963_027e750820_z.jpg,425,640,3,1,0.758523047,329,208,77.41176471,32.5,432,640,88,417
person,yolov8m,10921149963_027e750820_z.jpg,425,640,3,1,0.741067469,337,237,79.29411765,37.03125,0,237,79,416
person,yolov8m,10921149963_027e750820_z.jpg,425,640,3,1,0.444841236,212,223,49.88235294,34.84375,198,421,125,337
person,yolov8m,10921149963_027e750820_z.jpg,425,640,3,1,0.300585449,284,378,66.82352941,59.0625,194,572,122,406
person,yolov8m,10921149963_027e750820_z.jpg,425,640,3,1,0.254600048,341,438,80.23529412,68.4375,0,438,68,409
person,yolov8m,268134569_0cea602ccb_z.jpg,480,640,3,1,0.93023932,457,376,95.20833333,58.75,263,639,22,479
person,yolov8m,268134569_0cea602ccb_z.jpg,480,640,3,1,0.824216425,288,334,60,52.1875,1,335,191,479
person,yolov8m,268134569_0cea602ccb_z.jpg,480,640,3,1,0.792941689,343,318,71.45833333,49.6875,321,639,0,343
person,yolov8m,268134569_0cea602ccb_z.jpg,480,640,3,1,0.678972721,382,248,79.58333333,38.75,54,302,0,382
person,yolov8m,268134569_0cea602ccb_z.jpg,480,640,3,1,0.423424989,479,336,99.79166667,52.5,33,369,1,480
person,yolov8m,7163490183_0dff14b5d6_z.jpg,360,640,3,1,0.725624979,348,270,96.66666667,42.1875,39,309,7,355
person,yolov8m,8488918795_f8ba7dabb6_z.jpg,594,471,3,1,0.931906879,494,146,83.16498316,30.99787686,8,154,92,586
person,yolov8m,8488918795_f8ba7dabb6_z.jpg,594,471,3,1,0.911271751,490,145,82.49158249,30.78556263,154,299,81,571
person,yolov8m,8488918795_f8ba7dabb6_z.jpg,594,471,3,1,0.903149426,471,133,79.29292929,28.23779193,299,432,95,566
person,yolov8m,1444579876_8c02edf580_z.jpg,639,483,3,1,0.953732789,607,463,94.99217527,95.85921325,1,464,25,632
person,yolov8m,6111783458_61cc1f0f88_z.jpg,640,425,3,1,0.948953032,617,423,96.40625,99.52941176,1,424,22,639
person,yolov8m,10915137264_e8c23d54b4_z.jpg,639,428,3,1,0.951903403,485,317,75.89984351,74.06542056,46,363,153,638
person,yolov8m,4029738064_00c4cd038b_z.jpg,425,640,3,1,0.926665306,346,273,81.41176471,42.65625,48,321,74,420
person,yolov8m,6309741882_b074ee1a96_z.jpg,541,640,3,1,0.739440322,311,297,57.48613678,46.40625,1,298,223,534
person,yolov8m,6309741882_b074ee1a96_z.jpg,541,640,3,1,0.605629623,532,403,98.33641405,62.96875,235,638,0,532
person,yolov8m,8572756223_94130c5e61_z.jpg,481,640,3,1,0.941147745,465,349,96.67359667,54.53125,0,349,8,473
person,yolov8m,8572756223_94130c5e61_z.jpg,481,640,3,1,0.930450022,458,337,95.21829522,52.65625,302,639,16,474
person,yolov8m,16658372825_affc436763_z.jpg,640,369,3,1,0.888140917,407,162,63.59375,43.90243902,98,260,122,529
person,yolov8m,5298849761_aeeed1a3f9_z.jpg,640,425,3,1,0.955688,627,424,97.96875,99.76470588,0,424,11,638
person,yolov8m,16433605163_8c9393beb1_z.jpg,480,640,3,1,0.908450663,234,155,48.75,24.21875,102,257,160,394
person,yolov8m,16433605163_8c9393beb1_z.jpg,480,640,3,1,0.889658809,161,182,33.54166667,28.4375,426,608,319,480
person,yolov8m,16433605163_8c9393beb1_z.jpg,480,640,3,1,0.80663681,174,66,36.25,10.3125,43,109,152,326
person,yolov8m,16433605163_8c9393beb1_z.jpg,480,640,3,1,0.7886675,260,93,54.16666667,14.53125,445,538,156,416
person,yolov8m,16433605163_8c9393beb1_z.jpg,480,640,3,1,0.762794435,217,65,45.20833333,10.15625,332,397,159,376
person,yolov8m,16433605163_8c9393beb1_z.jpg,480,640,3,1,0.743338406,228,60,47.5,9.375,410,470,162,390
person,yolov8m,16433605163_8c9393beb1_z.jpg,480,640,3,1,0.712408185,262,96,54.58333333,15,544,640,152,414
person,yolov8m,16433605163_8c9393beb1_z.jpg,480,640,3,1,0.659449279,156,60,32.5,9.375,197,257,168,324
person,yolov8m,16433605163_8c9393beb1_z.jpg,480,640,3,1,0.61350596,146,67,30.41666667,10.46875,503,570,176,322
person,yolov8m,16433605163_8c9393beb1_z.jpg,480,640,3,1,0.584784865,133,44,27.70833333,6.875,280,324,162,295
person,yolov8m,16433605163_8c9393beb1_z.jpg,480,640,3,1,0.502488017,277,47,57.70833333,7.34375,593,640,148,425
person,yolov8m,16433605163_8c9393beb1_z.jpg,480,640,3,1,0.373912156,41,17,8.541666667,2.65625,0,17,168,209
person,yolov8m,16433605163_8c9393beb1_z.jpg,480,640,3,1,0.272548407,36,27,7.5,4.21875,141,168,165,201
person,yolov8m,16433605163_8c9393beb1_z.jpg,480,640,3,1,0.263819426,40,34,8.333333333,5.3125,94,128,165,205
person,yolov8m,16433605163_8c9393beb1_z.jpg,480,640,3,1,0.253917277,175,29,36.45833333,4.53125,390,419,180,355
person,yolov8m,15071673457_0703cea442_z.jpg,426,640,3,1,0.941522002,371,406,87.08920188,63.4375,100,506,49,420
person,yolov8m,300422857_eb3a885357_z.jpg,640,632,3,1,0.923762739,631,629,98.59375,99.52531646,3,632,5,636
person,yolov8m,2522213440_edbcb5ba05_z.jpg,428,639,3,1,0.955601811,385,290,89.95327103,45.38341158,247,537,38,423
person,yolov8m,2522213440_edbcb5ba05_z.jpg,428,639,3,1,0.857226372,93,237,21.72897196,37.08920188,402,639,333,426
person,yolov8m,2522213440_edbcb5ba05_z.jpg,428,639,3,1,0.824823618,320,156,74.76635514,24.41314554,482,638,74,394
person,yolov8m,2522213440_edbcb5ba05_z.jpg,428,639,3,1,0.691731453,176,75,41.12149533,11.7370892,8,83,55,231
person,yolov8m,6985531639_71621c1e69_z.jpg,427,640,3,1,0.933013201,418,584,97.89227166,91.25,46,630,2,420
person,yolov8m,892497288_b916ec820e_z.jpg,481,640,3,1,0.87612766,353,312,73.38877339,48.75,1,313,1,354
person,yolov8m,892497288_b916ec820e_z.jpg,481,640,3,1,0.52111268,391,419,81.28898129,65.46875,195,614,75,466
person,yolov8m,892497288_b916ec820e_z.jpg,481,640,3,1,0.498959094,314,199,65.28066528,31.09375,237,436,40,354
person,yolov8m,892497288_b916ec820e_z.jpg,481,640,3,1,0.473095983,64,71,13.30561331,11.09375,0,71,21,85
person,yolov8m,892497288_b916ec820e_z.jpg,481,640,3,1,0.325961888,295,310,61.33056133,48.4375,241,551,62,357
person,yolov8m,892497288_b916ec820e_z.jpg,481,640,3,1,0.293896884,208,416,43.24324324,65,193,609,256,464
person,yolov8m,2767937261_724bce0179_z.jpg,480,640,3,1,0.961534977,400,303,83.33333333,47.34375,201,504,79,479
person,yolov8m,16104664631_cce4a9a58c_z.jpg,480,620,3,1,0.848653734,423,389,88.125,62.74193548,0,389,50,473
person,yolov8m,16104664631_cce4a9a58c_z.jpg,480,620,3,1,0.421769947,85,64,17.70833333,10.32258065,493,557,394,479
person,yolov8m,3954929491_6e95503c3d_z.jpg,420,640,3,1,0.857802093,207,93,49.28571429,14.53125,23,116,212,419
person,yolov8m,3954929491_6e95503c3d_z.jpg,420,640,3,1,0.783058643,197,113,46.9047619,17.65625,524,637,221,418
person,yolov8m,3954929491_6e95503c3d_z.jpg,420,640,3,1,0.755162835,191,112,45.47619048,17.5,429,541,228,419
person,yolov8m,3954929491_6e95503c3d_z.jpg,420,640,3,1,0.669686556,188,100,44.76190476,15.625,191,291,230,418
person,yolov8m,3954929491_6e95503c3d_z.jpg,420,640,3,1,0.615851581,182,115,43.33333333,17.96875,336,451,238,420
person,yolov8m,3954929491_6e95503c3d_z.jpg,420,640,3,1,0.554267287,188,94,44.76190476,14.6875,107,201,231,419
person,yolov8m,3954929491_6e95503c3d_z.jpg,420,640,3,1,0.412341923,180,71,42.85714286,11.09375,284,355,240,420
person,yolov8m,3954929491_6e95503c3d_z.jpg,420,640,3,1,0.371233195,150,66,35.71428571,10.3125,478,544,158,308
person,yolov8m,3954929491_6e95503c3d_z.jpg,420,640,3,1,0.361007631,112,77,26.66666667,12.03125,292,369,187,299
person,yolov8m,11983632613_4efcf5f3d3_z.jpg,402,640,3,1,0.925858259,168,406,41.79104478,63.4375,234,640,192,360
person,yolov8m,11983632613_4efcf5f3d3_z.jpg,402,640,3,1,0.890537322,206,74,51.24378109,11.5625,19,93,9,215
person,yolov8m,11983632613_4efcf5f3d3_z.jpg,402,640,3,1,0.834625065,118,32,29.35323383,5,128,160,47,165
person,yolov8m,11983632613_4efcf5f3d3_z.jpg,402,640,3,1,0.808640361,124,48,30.84577114,7.5,0,48,50,174
person,yolov8m,11983632613_4efcf5f3d3_z.jpg,402,640,3,1,0.785326719,78,47,19.40298507,7.34375,297,344,46,124
person,yolov8m,11983632613_4efcf5f3d3_z.jpg,402,640,3,1,0.778440654,119,34,29.60199005,5.3125,81,115,49,168
person,yolov8m,11983632613_4efcf5f3d3_z.jpg,402,640,3,1,0.729876339,129,35,32.08955224,5.46875,343,378,21,150
person,yolov8m,11983632613_4efcf5f3d3_z.jpg,402,640,3,1,0.719441772,89,35,22.13930348,5.46875,475,510,33,122
person,yolov8m,11983632613_4efcf5f3d3_z.jpg,402,640,3,1,0.558865786,88,26,21.89054726,4.0625,260,286,64,152
person,yolov8m,15625756039_d59f4e16fa_z.jpg,480,640,3,1,0.946939468,352,157,73.33333333,24.53125,24,181,128,480
person,yolov8m,15625756039_d59f4e16fa_z.jpg,480,640,3,1,0.918166041,401,166,83.54166667,25.9375,205,371,78,479
person,yolov8m,15625756039_d59f4e16fa_z.jpg,480,640,3,1,0.915429831,352,138,73.33333333,21.5625,424,562,127,479
person,yolov8m,15625756039_d59f4e16fa_z.jpg,480,640,3,1,0.853630662,396,96,82.5,15,360,456,83,479
person,yolov8m,6217890759_2a6a04d1d9_z.jpg,427,640,3,1,0.932610571,302,110,70.72599532,17.1875,457,567,95,397
person,yolov8m,6217890759_2a6a04d1d9_z.jpg,427,640,3,1,0.918352544,311,111,72.83372365,17.34375,60,171,103,414
person,yolov8m,6217890759_2a6a04d1d9_z.jpg,427,640,3,1,0.906217515,303,85,70.96018735,13.28125,233,318,69,372
person,yolov8m,6217890759_2a6a04d1d9_z.jpg,427,640,3,1,0.893466532,280,97,65.57377049,15.15625,150,247,93,373
person,yolov8m,6217890759_2a6a04d1d9_z.jpg,427,640,3,1,0.889567673,317,100,74.23887588,15.625,308,408,62,379
person,yolov8m,6217890759_2a6a04d1d9_z.jpg,427,640,3,1,0.874970019,289,84,67.68149883,13.125,386,470,93,382
person,yolov8m,3195432512_d0a96b2967_z.jpg,640,480,3,1,0.842943609,636,480,99.375,100,0,480,1,637
person,yolov8m,16789366715_633121f7bb_z.jpg,640,457,3,1,0.945163012,637,391,99.53125,85.55798687,66,457,2,639
person,yolov8m,3442716929_7a26250063_z.jpg,640,427,3,1,0.958631694,586,424,91.5625,99.29742389,1,425,53,639
person,yolov8m,5943858783_a2cc450fb3_z.jpg,421,639,3,1,0.936044157,378,170,89.78622328,26.60406886,237,407,39,417
person,yolov8m,5943858783_a2cc450fb3_z.jpg,421,639,3,1,0.926004291,385,159,91.44893112,24.88262911,384,543,33,418
person,yolov8m,5943858783_a2cc450fb3_z.jpg,421,639,3,1,0.91348356,365,156,86.69833729,24.41314554,0,156,51,416
person,yolov8m,5943858783_a2cc450fb3_z.jpg,421,639,3,1,0.836344838,323,140,76.72209026,21.90923318,127,267,94,417
person,yolov8m,5425389979_390e3f3881_z.jpg,456,640,3,1,0.831609905,119,118,26.09649123,18.4375,14,132,292,411
person,yolov8m,5425389979_390e3f3881_z.jpg,456,640,3,1,0.789734423,112,106,24.56140351,16.5625,534,640,302,414
person,yolov8m,5425389979_390e3f3881_z.jpg,456,640,3,1,0.771170795,124,105,27.19298246,16.40625,130,235,275,399
person,yolov8m,5425389979_390e3f3881_z.jpg,456,640,3,1,0.769307554,174,95,38.15789474,14.84375,97,192,173,347
person,yolov8m,5425389979_390e3f3881_z.jpg,456,640,3,1,0.757018685,122,96,26.75438596,15,431,527,280,402
person,yolov8m,5425389979_390e3f3881_z.jpg,456,640,3,1,0.740449131,214,100,46.92982456,15.625,12,112,169,383
person,yolov8m,5425389979_390e3f3881_z.jpg,456,640,3,1,0.736023545,185,97,40.57017544,15.15625,510,607,179,364
person,yolov8m,5425389979_390e3f3881_z.jpg,456,640,3,1,0.672480106,210,80,46.05263158,12.5,190,270,161,371
person,yolov8m,5425389979_390e3f3881_z.jpg,456,640,3,1,0.647572935,182,93,39.9122807,14.53125,352,445,177,359
person,yolov8m,5425389979_390e3f3881_z.jpg,456,640,3,1,0.614153922,107,105,23.46491228,16.40625,329,434,293,400
person,yolov8m,5425389979_390e3f3881_z.jpg,456,640,3,1,0.591685474,105,94,23.02631579,14.6875,234,328,292,397
person,yolov8m,5425389979_390e3f3881_z.jpg,456,640,3,1,0.554685831,170,92,37.28070175,14.375,436,528,169,339
person,yolov8m,5425389979_390e3f3881_z.jpg,456,640,3,1,0.54637742,200,95,43.85964912,14.84375,266,361,156,356
person,yolov8m,5425389979_390e3f3881_z.jpg,456,640,3,1,0.336123109,135,70,29.60526316,10.9375,76,146,103,238
person,yolov8m,5425389979_390e3f3881_z.jpg,456,640,3,1,0.259415984,141,76,30.92105263,11.875,349,425,92,233
person,yolov8m,5387089136_efcdc42456_z.jpg,431,640,3,1,0.938029766,345,94,80.04640371,14.6875,0,94,48,393
person,yolov8m,5387089136_efcdc42456_z.jpg,431,640,3,1,0.927007318,371,99,86.07888631,15.46875,541,640,55,426
person,yolov8m,5387089136_efcdc42456_z.jpg,431,640,3,1,0.914297163,228,99,52.90023202,15.46875,238,337,198,426
person,yolov8m,5387089136_efcdc42456_z.jpg,431,640,3,1,0.911275983,230,86,53.36426914,13.4375,170,256,194,424
person,yolov8m,5387089136_efcdc42456_z.jpg,431,640,3,1,0.903405726,231,101,53.5962877,15.78125,401,502,197,428
person,yolov8m,5387089136_efcdc42456_z.jpg,431,640,3,1,0.897776484,243,90,56.38051044,14.0625,331,421,188,431
person,yolov8m,5387089136_efcdc42456_z.jpg,431,640,3,1,0.88347441,265,98,61.48491879,15.3125,83,181,165,430
person,yolov8m,5387089136_efcdc42456_z.jpg,431,640,3,1,0.872954905,245,99,56.84454756,15.46875,494,593,185,430
person,yolov8m,5387089136_efcdc42456_z.jpg,431,640,3,1,0.854430079,87,79,20.18561485,12.34375,297,376,7,94
person,yolov8m,5387089136_efcdc42456_z.jpg,431,640,3,1,0.84675312,176,80,40.83526682,12.5,79,159,69,245
person,yolov8m,5387089136_efcdc42456_z.jpg,431,640,3,1,0.846157372,58,86,13.45707657,13.4375,360,446,37,95
person,yolov8m,5387089136_efcdc42456_z.jpg,431,640,3,1,0.8278054,148,70,34.3387471,10.9375,516,586,42,190
person,yolov8m,5387089136_efcdc42456_z.jpg,431,640,3,1,0.754379809,79,61,18.32946636,9.53125,480,541,29,108
person,yolov8m,5387089136_efcdc42456_z.jpg,431,640,3,1,0.61310941,63,69,14.61716937,10.78125,229,298,30,93
person,yolov8m,5387089136_efcdc42456_z.jpg,431,640,3,1,0.456120312,120,62,27.84222738,9.6875,131,193,27,147
person,yolov8m,5387089136_efcdc42456_z.jpg,431,640,3,1,0.435177565,65,35,15.0812065,5.46875,49,84,68,133
person,yolov8m,5387089136_efcdc42456_z.jpg,431,640,3,1,0.313050479,72,61,16.70533643,9.53125,131,192,27,99
person,yolov8m,3300269400_c276d7a1a7_z.jpg,469,639,3,1,0.95430094,448,595,95.52238806,93.114241,33,628,13,461
person,yolov8m,528252616_a57e6257ff_z.jpg,480,640,3,1,0.932351947,331,167,68.95833333,26.09375,0,167,149,480
person,yolov8m,528252616_a57e6257ff_z.jpg,480,640,3,1,0.862735629,354,221,73.75,34.53125,419,640,125,479
person,yolov8m,528252616_a57e6257ff_z.jpg,480,640,3,1,0.692071855,450,363,93.75,56.71875,208,571,30,480
person,yolov8m,6723753569_a1d8678cde_z.jpg,640,425,3,1,0.968707502,604,422,94.375,99.29411765,1,423,34,638
person,yolov8m,201365540_d1af73d7cd_z.jpg,640,482,3,1,0.928450227,603,482,94.21875,100,0,482,34,637
person,yolov8m,15091650494_d8a5f37637_z.jpg,640,427,3,1,0.976406395,583,426,91.09375,99.76580796,0,426,55,638
person,yolov8m,2365652301_0de626bd97_z.jpg,498,640,3,1,0.930840313,351,124,70.48192771,19.375,391,515,72,423
person,yolov8m,2365652301_0de626bd97_z.jpg,498,640,3,1,0.886479199,311,146,62.4497992,22.8125,222,368,115,426
person,yolov8m,8960442702_6c931904f0_z.jpg,427,640,3,1,0.939353406,422,227,98.82903981,35.46875,266,493,1,423
person,yolov8m,8960442702_6c931904f0_z.jpg,427,640,3,1,0.918593407,420,182,98.36065574,28.4375,85,267,3,423
person,yolov8m,5594762666_e157f338f0_z.jpg,425,640,3,1,0.949308395,396,294,93.17647059,45.9375,346,640,23,419
person,yolov8m,5594762666_e157f338f0_z.jpg,425,640,3,1,0.901680589,370,326,87.05882353,50.9375,0,326,49,419
person,yolov8m,7192116992_5447de0caa_z.jpg,640,480,3,1,0.961048603,610,478,95.3125,99.58333333,1,479,28,638
person,yolov8m,8562326627_1a68052e58_z.jpg,640,582,3,1,0.703744709,633,582,98.90625,100,0,582,4,637
person,yolov8m,4380790081_1cbcb573ec_z.jpg,421,640,3,1,0.955963016,374,590,88.83610451,92.1875,33,623,40,414
person,yolov8m,15392489891_905432249f_z.jpg,427,640,3,1,0.922141612,293,190,68.61826698,29.6875,63,253,0,293
person,yolov8m,15392489891_905432249f_z.jpg,427,640,3,1,0.920847356,246,185,57.61124122,28.90625,337,522,179,425
person,yolov8m,15392489891_905432249f_z.jpg,427,640,3,1,0.894745827,257,229,60.18735363,35.78125,123,352,161,418
person,yolov8m,15392489891_905432249f_z.jpg,427,640,3,1,0.808473647,102,81,23.88758782,12.65625,349,430,147,249
person,yolov8m,15392489891_905432249f_z.jpg,427,640,3,1,0.692311645,56,47,13.1147541,7.34375,241,288,132,188
person,yolov8m,15392489891_905432249f_z.jpg,427,640,3,1,0.321005523,109,59,25.52693208,9.21875,242,301,132,241
person,yolov8m,4479906928_4ab0604d1c_z.jpg,640,480,3,1,0.906697273,638,343,99.6875,71.45833333,41,384,1,639
person,yolov8m,2392419690_8495e2b2c9_z.jpg,496,640,3,1,0.94539541,243,198,48.99193548,30.9375,323,521,1,244
person,yolov8m,2392419690_8495e2b2c9_z.jpg,496,640,3,1,0.941794217,241,190,48.58870968,29.6875,3,193,251,492
person,yolov8m,2392419690_8495e2b2c9_z.jpg,496,640,3,1,0.937524259,242,257,48.79032258,40.15625,3,260,2,244
person,yolov8m,2392419690_8495e2b2c9_z.jpg,496,640,3,1,0.890672266,76,61,15.32258065,9.53125,16,77,251,327
person,yolov8m,2392419690_8495e2b2c9_z.jpg,496,640,3,1,0.795085371,183,194,36.89516129,30.3125,421,615,310,493
person,yolov8m,2392419690_8495e2b2c9_z.jpg,496,640,3,1,0.757310033,130,180,26.20967742,28.125,421,601,115,245
person,yolov8m,2392419690_8495e2b2c9_z.jpg,496,640,3,1,0.660468102,239,161,48.18548387,25.15625,323,484,251,490
person,yolov8m,2392419690_8495e2b2c9_z.jpg,496,640,3,1,0.505049944,80,55,16.12903226,8.59375,323,378,2,82
person,yolov8m,2392419690_8495e2b2c9_z.jpg,496,640,3,1,0.417325824,109,138,21.97580645,21.5625,119,257,384,493
person,yolov8m,8538565946_199e28b584_z.jpg,612,612,3,1,0.932745159,598,522,97.7124183,85.29411765,64,586,12,610
person,yolov8m,15083791924_c7195faca3_z.jpg,428,640,3,1,0.95941031,423,399,98.8317757,62.34375,51,450,0,423
person,yolov8m,8922688952_9cacbffe29_z.jpg,639,402,3,1,0.668803155,636,260,99.53051643,64.67661692,1,261,1,637
person,yolov8m,8922688952_9cacbffe29_z.jpg,639,402,3,1,0.664083004,635,392,99.37402191,97.51243781,9,401,2,637
person,yolov8m,5540859766_5596c9c59e_z.jpg,520,600,3,1,0.960186064,476,584,91.53846154,97.33333333,0,584,34,510
person,yolov8m,5826499075_8c91ec270b_z.jpg,640,478,3,1,0.86797595,572,360,89.375,75.31380753,59,419,65,637
person,yolov8m,4728907141_f9e5aa4bce_z.jpg,480,640,3,1,0.943862557,324,206,67.5,32.1875,186,392,58,382
person,yolov8m,4728907141_f9e5aa4bce_z.jpg,480,640,3,1,0.916728735,182,106,37.91666667,16.5625,0,106,22,204
person,yolov8m,4728907141_f9e5aa4bce_z.jpg,480,640,3,1,0.84360224,167,94,34.79166667,14.6875,493,587,18,185
person,yolov8m,5316877862_ccdebd50e5_z.jpg,419,639,3,1,0.947750509,363,350,86.63484487,54.77308294,288,638,53,416
person,yolov8m,5316877862_ccdebd50e5_z.jpg,419,639,3,1,0.924945295,380,227,90.69212411,35.52425665,13,240,34,414
person,yolov8m,5316877862_ccdebd50e5_z.jpg,419,639,3,1,0.880895615,410,87,97.85202864,13.61502347,0,87,1,411
person,yolov8m,5316877862_ccdebd50e5_z.jpg,419,639,3,1,0.704258978,53,53,12.64916468,8.294209703,297,350,366,419
person,yolov8m,5316877862_ccdebd50e5_z.jpg,419,639,3,1,0.617044985,266,68,63.48448687,10.64162754,192,260,95,361
person,yolov8m,5316877862_ccdebd50e5_z.jpg,419,639,3,1,0.598307133,205,36,48.92601432,5.633802817,241,277,213,418
person,yolov8m,5316877862_ccdebd50e5_z.jpg,419,639,3,1,0.453791201,73,25,17.42243437,3.912363067,77,102,38,111
person,yolov8m,5316877862_ccdebd50e5_z.jpg,419,639,3,1,0.407726526,39,26,9.307875895,4.06885759,279,305,380,419
person,yolov8m,5316877862_ccdebd50e5_z.jpg,419,639,3,1,0.361330301,93,69,22.19570406,10.79812207,193,262,267,360
person,yolov8m,5316877862_ccdebd50e5_z.jpg,419,639,3,1,0.308983564,116,33,27.6849642,5.164319249,68,101,38,154
person,yolov8m,15543230406_71c5a59208_z.jpg,463,640,3,1,0.924275279,365,244,78.8336933,38.125,227,471,92,457
person,yolov8m,15543230406_71c5a59208_z.jpg,463,640,3,1,0.86752224,365,342,78.8336933,53.4375,297,639,93,458
person,yolov8m,15543230406_71c5a59208_z.jpg,463,640,3,1,0.834658027,432,280,93.30453564,43.75,1,281,23,455
person,yolov8m,6431185703_6c72dd7b5e_z.jpg,427,640,3,1,0.733944714,134,49,31.38173302,7.65625,210,259,186,320
person,yolov8m,6431185703_6c72dd7b5e_z.jpg,427,640,3,1,0.716616511,170,71,39.81264637,11.09375,345,416,185,355
person,yolov8m,6431185703_6c72dd7b5e_z.jpg,427,640,3,1,0.698327243,149,69,34.89461358,10.78125,425,494,189,338
person,yolov8m,6431185703_6c72dd7b5e_z.jpg,427,640,3,1,0.688939035,153,55,35.83138173,8.59375,293,348,187,340
person,yolov8m,6431185703_6c72dd7b5e_z.jpg,427,640,3,1,0.663422644,111,38,25.99531616,5.9375,118,156,191,302
person,yolov8m,6431185703_6c72dd7b5e_z.jpg,427,640,3,1,0.655472159,98,35,22.95081967,5.46875,87,122,193,291
person,yolov8m,6431185703_6c72dd7b5e_z.jpg,427,640,3,1,0.650567472,100,35,23.41920375,5.46875,159,194,208,308
person,yolov8m,6431185703_6c72dd7b5e_z.jpg,427,640,3,1,0.553896129,122,48,28.57142857,7.5,491,539,197,319
person,yolov8m,6431185703_6c72dd7b5e_z.jpg,427,640,3,1,0.519936383,100,69,23.41920375,10.78125,552,621,202,302
person,yolov8m,6431185703_6c72dd7b5e_z.jpg,427,640,3,1,0.390718788,89,29,20.84309133,4.53125,61,90,196,285
person,yolov8m,6431185703_6c72dd7b5e_z.jpg,427,640,3,1,0.341565371,100,32,23.41920375,5,185,217,189,289
person,yolov8m,6431185703_6c72dd7b5e_z.jpg,427,640,3,1,0.314827383,112,49,26.2295082,7.65625,471,520,175,287
person,yolov8m,6431185703_6c72dd7b5e_z.jpg,427,640,3,1,0.280568659,78,27,18.26697892,4.21875,42,69,203,281
person,yolov8m,6431185703_6c72dd7b5e_z.jpg,427,640,3,1,0.260243326,98,32,22.95081967,5,250,282,181,279
person,yolov8n,6499183869_45bb8908c3_z.jpg,640,427,3,1,0.927703857,583,423,91.09375,99.06323185,0,423,57,640
person,yolov8n,3409776362_07a8bb7f17_z.jpg,523,640,3,1,0.797707677,473,480,90.43977055,75,70,550,44,517
person,yolov8n,8399932836_19c21d3779_z.jpg,640,524,3,1,0.923718274,566,420,88.4375,80.15267176,97,517,61,627
person,yolov8n,8349516772_6928ba8b88_z.jpg,480,640,3,1,0.89322412,433,435,90.20833333,67.96875,75,510,37,470
person,yolov8n,738798561_2d54b53ec5_z.jpg,640,480,3,1,0.906145573,578,446,90.3125,92.91666667,26,472,51,629
person,yolov8n,4282546783_10b5e0a62e_z.jpg,480,640,3,1,0.958323181,478,184,99.58333333,28.75,0,184,0,478
person,yolov8n,4282546783_10b5e0a62e_z.jpg,480,640,3,1,0.839756727,394,150,82.08333333,23.4375,214,364,85,479
person,yolov8n,4282546783_10b5e0a62e_z.jpg,480,640,3,1,0.753536284,265,90,55.20833333,14.0625,390,480,162,427
person,yolov8n,4282546783_10b5e0a62e_z.jpg,480,640,3,1,0.70684123,198,98,41.25,15.3125,137,235,261,459
person,yolov8n,4282546783_10b5e0a62e_z.jpg,480,640,3,1,0.698094666,332,88,69.16666667,13.75,316,404,130,462
person,yolov8n,4282546783_10b5e0a62e_z.jpg,480,640,3,1,0.696668386,111,47,23.125,7.34375,575,622,255,366
person,yolov8n,4282546783_10b5e0a62e_z.jpg,480,640,3,1,0.652887166,137,46,28.54166667,7.1875,511,557,244,381
person,yolov8n,4282546783_10b5e0a62e_z.jpg,480,640,3,1,0.526263714,211,56,43.95833333,8.75,458,514,188,399
person,yolov8n,4282546783_10b5e0a62e_z.jpg,480,640,3,1,0.398319542,222,59,46.25,9.21875,448,507,182,404
person,yolov8n,4282546783_10b5e0a62e_z.jpg,480,640,3,1,0.351121247,113,29,23.54166667,4.53125,537,566,241,354
person,yolov8n,4282546783_10b5e0a62e_z.jpg,480,640,3,1,0.314830244,132,25,27.5,3.90625,535,560,243,375
person,yolov8n,7166182137_a5679c9fa4_z.jpg,640,427,3,1,0.915178359,544,344,85,80.56206089,13,357,95,639
person,yolov8n,4386974407_c2915fa9b1_z.jpg,639,457,3,1,0.924141586,418,175,65.41471049,38.29321663,141,316,94,512
person,yolov8n,6881088206_947a7622d4_z.jpg,640,480,3,1,0.898340762,458,281,71.5625,58.54166667,139,420,95,553
person,yolov8n,6881088206_947a7622d4_z.jpg,640,480,3,1,0.801386118,334,118,52.1875,24.58333333,0,118,306,640
person,yolov8n,8874948232_195679aa4e_z.jpg,427,640,3,1,0.918334961,321,203,75.17564403,31.71875,0,203,101,422
person,yolov8n,8874948232_195679aa4e_z.jpg,427,640,3,1,0.888702512,412,248,96.48711944,38.75,284,532,10,422
person,yolov8n,8874948232_195679aa4e_z.jpg,427,640,3,1,0.804378331,234,103,54.80093677,16.09375,467,570,115,349
person,yolov8n,8874948232_195679aa4e_z.jpg,427,640,3,1,0.798286021,169,237,39.57845433,37.03125,179,416,254,423
person,yolov8n,8874948232_195679aa4e_z.jpg,427,640,3,1,0.776133835,191,176,44.73067916,27.5,462,638,0,191
person,yolov8n,8874948232_195679aa4e_z.jpg,427,640,3,1,0.774246156,141,117,33.02107728,18.28125,523,640,282,423
person,yolov8n,8874948232_195679aa4e_z.jpg,427,640,3,1,0.744541526,141,87,33.02107728,13.59375,553,640,161,302
person,yolov8n,8874948232_195679aa4e_z.jpg,427,640,3,1,0.360536188,314,304,73.53629977,47.5,5,309,75,389
person,yolov8n,8874948232_195679aa4e_z.jpg,427,640,3,1,0.29192555,302,208,70.72599532,32.5,102,310,74,376
person,yolov8n,8874948232_195679aa4e_z.jpg,427,640,3,1,0.269377708,168,40,39.3442623,6.25,600,640,4,172
person,yolov8n,202416281_527efb7418_z.jpg,639,469,3,1,0.78494525,476,209,74.4913928,44.56289979,168,377,129,605
person,yolov8n,5605719660_5bed05cca3_z.jpg,425,640,3,1,0.915411234,419,405,98.58823529,63.28125,234,639,0,419
person,yolov8n,5605719660_5bed05cca3_z.jpg,425,640,3,1,0.88997829,405,249,95.29411765,38.90625,1,250,12,417
person,yolov8n,16850385890_8105762655_z.jpg,640,425,3,1,0.804299474,567,425,88.59375,100,0,425,72,639
person,yolov8n,98052295_1221189a77_z.jpg,534,640,3,1,0.902165949,533,640,99.81273408,100,0,640,0,533
person,yolov8n,4030862073_d697f506b0_z.jpg,601,640,3,1,0.892602265,546,327,90.84858569,51.09375,4,331,49,595
person,yolov8n,4030862073_d697f506b0_z.jpg,601,640,3,1,0.813710332,566,373,94.17637271,58.28125,264,637,27,593
person,yolov8n,2768961204_712996d2bd_z.jpg,639,355,3,1,0.892673314,466,216,72.92644757,60.84507042,102,318,122,588
person,yolov8n,15983066535_629c335c63_z.jpg,427,640,3,1,0.925620496,406,461,95.08196721,72.03125,108,569,15,421
person,yolov8n,2946145533_75f5268f19_z.jpg,480,640,3,1,0.722618937,479,620,99.79166667,96.875,4,624,0,479
person,yolov8n,8744937858_81c17befae_z.jpg,640,426,3,1,0.890084088,484,316,75.625,74.17840376,51,367,64,548
person,yolov8n,8183126241_e78c7f86ba_z.jpg,425,640,3,1,0.937970281,417,328,98.11764706,51.25,5,333,4,421
person,yolov8n,8183126241_e78c7f86ba_z.jpg,425,640,3,1,0.857187271,378,281,88.94117647,43.90625,300,581,42,420
person,yolov8n,8183126241_e78c7f86ba_z.jpg,425,640,3,1,0.523182273,196,65,46.11764706,10.15625,546,611,225,421
person,yolov8n,16954781749_4c32123444_z.jpg,427,640,3,1,0.944299459,335,211,78.45433255,32.96875,138,349,86,421
person,yolov8n,16954781749_4c32123444_z.jpg,427,640,3,1,0.928560674,328,206,76.81498829,32.1875,331,537,94,422
person,yolov8n,7581740758_a1c5cf246e_z.jpg,640,427,3,1,0.927209795,547,405,85.46875,94.84777518,3,408,91,638
person,yolov8n,5298850167_d1e13e9551_z.jpg,391,640,3,1,0.885352075,348,220,89.00255754,34.375,420,640,29,377
person,yolov8n,5298850167_d1e13e9551_z.jpg,391,640,3,1,0.803661406,258,153,65.98465473,23.90625,0,153,52,310
person,yolov8n,5298850167_d1e13e9551_z.jpg,391,640,3,1,0.789947033,317,310,81.0741688,48.4375,175,485,69,386
person,yolov8n,5298850167_d1e13e9551_z.jpg,391,640,3,1,0.60762614,306,235,78.26086957,36.71875,63,298,55,361
person,yolov8n,4901520304_aa5c10705e_z.jpg,480,640,3,1,0.90107131,479,621,99.79166667,97.03125,0,621,0,479
person,yolov8n,14507981482_c50d893620_z.jpg,640,503,3,1,0.855228841,470,145,73.4375,28.82703777,34,179,108,578
person,yolov8n,14507981482_c50d893620_z.jpg,640,503,3,1,0.798214197,282,93,44.0625,18.48906561,359,452,337,619
person,yolov8n,14507981482_c50d893620_z.jpg,640,503,3,1,0.790551186,519,160,81.09375,31.80914513,194,354,108,627
person,yolov8n,14507981482_c50d893620_z.jpg,640,503,3,1,0.750410438,363,156,56.71875,31.0139165,328,484,94,457
person,yolov8n,14507981482_c50d893620_z.jpg,640,503,3,1,0.727535427,394,127,61.5625,25.24850895,135,262,66,460
person,yolov8n,14507981482_c50d893620_z.jpg,640,503,3,1,0.68830502,106,47,16.5625,9.343936382,322,369,69,175
person,yolov8n,14507981482_c50d893620_z.jpg,640,503,3,1,0.674705625,109,51,17.03125,10.13916501,117,168,59,168
person,yolov8n,14507981482_c50d893620_z.jpg,640,503,3,1,0.602340221,365,85,57.03125,16.89860835,404,489,54,419
person,yolov8n,14507981482_c50d893620_z.jpg,640,503,3,1,0.262609541,378,81,59.0625,16.10337972,149,230,120,498
person,yolov8n,7742706992_27215ef7f8_z.jpg,640,428,3,1,0.844386816,529,310,82.65625,72.42990654,82,392,111,640
person,yolov8n,7742706992_27215ef7f8_z.jpg,640,428,3,1,0.667820811,410,177,64.0625,41.35514019,232,409,43,453
person,yolov8n,7742706992_27215ef7f8_z.jpg,640,428,3,1,0.425891846,133,91,20.78125,21.26168224,1,92,507,640
person,yolov8n,7742706992_27215ef7f8_z.jpg,640,428,3,1,0.379108846,181,31,28.28125,7.242990654,396,427,164,345
person,yolov8n,11132512636_ebb3a6a070_z.jpg,427,640,3,1,0.804644346,366,153,85.71428571,23.90625,409,562,46,412
person,yolov8n,11132512636_ebb3a6a070_z.jpg,427,640,3,1,0.746319115,235,75,55.03512881,11.71875,320,395,147,382
person,yolov8n,11132512636_ebb3a6a070_z.jpg,427,640,3,1,0.596050799,299,98,70.0234192,15.3125,230,328,94,393
person,yolov8n,11132512636_ebb3a6a070_z.jpg,427,640,3,1,0.551353753,261,147,61.12412178,22.96875,64,211,120,381
person,yolov8n,11132512636_ebb3a6a070_z.jpg,427,640,3,1,0.31163767,264,71,61.82669789,11.09375,194,265,116,380
person,yolov8n,7843905188_07e5d2a569_z.jpg,425,640,3,1,0.449590653,345,388,81.17647059,60.625,0,388,75,420
person,yolov8n,7843905188_07e5d2a569_z.jpg,425,640,3,1,0.402602583,403,332,94.82352941,51.875,307,639,18,421
person,yolov8n,7843905188_07e5d2a569_z.jpg,425,640,3,1,0.307885647,360,632,84.70588235,98.75,2,634,59,419
person,yolov8n,189076128_ee6f694a30_z.jpg,640,428,3,1,0.858085096,588,428,91.875,100,0,428,51,639
person,yolov8n,6098643678_fc8044b5ac_z.jpg,427,640,3,1,0.941728234,365,260,85.48009368,40.625,380,640,57,422
person,yolov8n,6098643678_fc8044b5ac_z.jpg,427,640,3,1,0.896469355,318,288,74.47306792,45,0,288,104,422
person,yolov8n,6098643678_fc8044b5ac_z.jpg,427,640,3,1,0.856527865,279,226,65.33957845,35.3125,242,468,143,422
person,yolov8n,2534669669_0c1d10c3e6_z.jpg,480,640,3,1,0.853966713,477,618,99.375,96.5625,2,620,1,478
person,yolov8n,5210291488_fe9939bdf1_z.jpg,360,640,3,1,0.893081784,163,72,45.27777778,11.25,436,508,137,300
person,yolov8n,5210291488_fe9939bdf1_z.jpg,360,640,3,1,0.869736433,169,58,46.94444444,9.0625,263,321,123,292
person,yolov8n,5210291488_fe9939bdf1_z.jpg,360,640,3,1,0.862340987,180,61,50,9.53125,150,211,109,289
person,yolov8n,5210291488_fe9939bdf1_z.jpg,360,640,3,1,0.830385745,174,65,48.33333333,10.15625,204,269,115,289
person,yolov8n,5210291488_fe9939bdf1_z.jpg,360,640,3,1,0.801698089,159,53,44.16666667,8.28125,38,91,120,279
person,yolov8n,5210291488_fe9939bdf1_z.jpg,360,640,3,1,0.776581585,159,68,44.16666667,10.625,365,433,134,293
person,yolov8n,5210291488_fe9939bdf1_z.jpg,360,640,3,1,0.763801992,186,63,51.66666667,9.84375,318,381,113,299
person,yolov8n,5210291488_fe9939bdf1_z.jpg,360,640,3,1,0.741824985,105,53,29.16666667,8.28125,518,571,152,257
person,yolov8n,5210291488_fe9939bdf1_z.jpg,360,640,3,1,0.650666773,155,52,43.05555556,8.125,93,145,130,285
person,yolov8n,5210291488_fe9939bdf1_z.jpg,360,640,3,1,0.427411705,53,33,14.72222222,5.15625,261,294,104,157
person,yolov8n,5210291488_fe9939bdf1_z.jpg,360,640,3,1,0.379772991,170,63,47.22222222,9.84375,577,640,160,330
person,yolov8n,5210291488_fe9939bdf1_z.jpg,360,640,3,1,0.298488557,173,43,48.05555556,6.71875,80,123,113,286
person,yolov8n,5210291488_fe9939bdf1_z.jpg,360,640,3,1,0.265107065,108,63,30,9.84375,577,640,161,269
person,yolov8n,4083309359_020d325f73_z.jpg,640,427,3,1,0.935991466,614,424,95.9375,99.29742389,0,424,25,639
person,yolov8n,8031274301_1d9bc9b665_z.jpg,640,427,3,1,0.864101291,572,334,89.375,78.22014052,5,339,68,640
person,yolov8n,8031274301_1d9bc9b665_z.jpg,640,427,3,1,0.784533799,637,185,99.53125,43.32552693,241,426,0,637
person,yolov8n,5481347426_620620145e_z.jpg,427,640,3,1,0.934953988,388,170,90.86651054,26.5625,0,170,35,423
person,yolov8n,5481347426_620620145e_z.jpg,427,640,3,1,0.918824315,385,232,90.16393443,36.25,197,429,38,423
person,yolov8n,5481347426_620620145e_z.jpg,427,640,3,1,0.893383622,236,103,55.26932084,16.09375,516,619,187,423
person,yolov8n,5481347426_620620145e_z.jpg,427,640,3,1,0.879229486,248,87,58.07962529,13.59375,453,540,175,423
person,yolov8n,5481347426_620620145e_z.jpg,427,640,3,1,0.612600923,337,102,78.92271663,15.9375,197,299,85,422
person,yolov8n,5481347426_620620145e_z.jpg,427,640,3,1,0.522943079,216,22,50.58548009,3.4375,618,640,207,423
person,yolov8n,5481347426_620620145e_z.jpg,427,640,3,1,0.460275739,266,67,62.29508197,10.46875,110,177,156,422
person,yolov8n,5481347426_620620145e_z.jpg,427,640,3,1,0.399067044,153,63,35.83138173,9.84375,389,452,231,384
person,yolov8n,5513074265_5b31a2339b_z.jpg,428,639,3,1,0.78619957,421,507,98.36448598,79.342723,3,510,3,424
person,yolov8n,5513074265_5b31a2339b_z.jpg,428,639,3,1,0.455830455,419,277,97.89719626,43.34898279,2,279,3,422
person,yolov8n,10921149963_027e750820_z.jpg,425,640,3,1,0.794397652,332,205,78.11764706,32.03125,435,640,86,418
person,yolov8n,10921149963_027e750820_z.jpg,425,640,3,1,0.501552463,353,615,83.05882353,96.09375,1,616,69,422
person,yolov8n,10921149963_027e750820_z.jpg,425,640,3,1,0.379242599,286,451,67.29411765,70.46875,4,455,62,348
person,yolov8n,10921149963_027e750820_z.jpg,425,640,3,1,0.322570622,299,492,70.35294118,76.875,77,569,115,414
person,yolov8n,10921149963_027e750820_z.jpg,425,640,3,1,0.252300858,249,354,58.58823529,55.3125,201,555,123,372
person,yolov8n,268134569_0cea602ccb_z.jpg,480,640,3,1,0.84808439,476,376,99.16666667,58.75,264,640,4,480
person,yolov8n,268134569_0cea602ccb_z.jpg,480,640,3,1,0.647166371,355,323,73.95833333,50.46875,317,640,0,355
person,yolov8n,268134569_0cea602ccb_z.jpg,480,640,3,1,0.452219188,477,367,99.375,57.34375,0,367,2,479
person,yolov8n,268134569_0cea602ccb_z.jpg,480,640,3,1,0.423626691,295,356,61.45833333,55.625,0,356,184,479
person,yolov8n,268134569_0cea602ccb_z.jpg,480,640,3,1,0.38645041,383,294,79.79166667,45.9375,4,298,0,383
person,yolov8n,7163490183_0dff14b5d6_z.jpg,360,640,3,1,0.571715355,345,256,95.83333333,40,47,303,6,351
person,yolov8n,8488918795_f8ba7dabb6_z.jpg,594,471,3,1,0.873660088,491,146,82.65993266,30.99787686,8,154,93,584
person,yolov8n,8488918795_f8ba7dabb6_z.jpg,594,471,3,1,0.860477567,470,128,79.12457912,27.17622081,307,435,94,564
person,yolov8n,8488918795_f8ba7dabb6_z.jpg,594,471,3,1,0.848506391,480,150,80.80808081,31.84713376,150,300,89,569
person,yolov8n,1444579876_8c02edf580_z.jpg,639,483,3,1,0.921817839,600,469,93.89671362,97.10144928,1,470,32,632
person,yolov8n,6111783458_61cc1f0f88_z.jpg,640,425,3,1,0.794876635,619,421,96.71875,99.05882353,3,424,19,638
person,yolov8n,6111783458_61cc1f0f88_z.jpg,640,425,3,1,0.320866495,52,173,8.125,40.70588235,240,413,588,640
person,yolov8n,10915137264_e8c23d54b4_z.jpg,639,428,3,1,0.864306569,469,302,73.39593114,70.56074766,62,364,169,638
person,yolov8n,4029738064_00c4cd038b_z.jpg,425,640,3,1,0.84561342,351,275,82.58823529,42.96875,48,323,71,422
person,yolov8n,6309741882_b074ee1a96_z.jpg,541,640,3,1,0.715750933,528,618,97.59704251,96.5625,20,638,3,531
person,yolov8n,6309741882_b074ee1a96_z.jpg,541,640,3,1,0.67716819,319,287,58.96487985,44.84375,1,288,212,531
person,yolov8n,6309741882_b074ee1a96_z.jpg,541,640,3,1,0.461588591,528,438,97.59704251,68.4375,201,639,0,528
person,yolov8n,8572756223_94130c5e61_z.jpg,481,640,3,1,0.921242237,456,338,94.8024948,52.8125,299,637,19,475
person,yolov8n,8572756223_94130c5e61_z.jpg,481,640,3,1,0.892266929,460,351,95.63409563,54.84375,0,351,8,468
person,yolov8n,16658372825_affc436763_z.jpg,640,369,3,1,0.819111943,391,156,61.09375,42.27642276,103,259,123,514
person,yolov8n,5298849761_aeeed1a3f9_z.jpg,640,425,3,1,0.914782763,631,424,98.59375,99.76470588,0,424,9,640
person,yolov8n,16433605163_8c9393beb1_z.jpg,480,640,3,1,0.839880228,174,70,36.25,10.9375,37,107,151,325
person,yolov8n,16433605163_8c9393beb1_z.jpg,480,640,3,1,0.82348001,245,77,51.04166667,12.03125,459,536,159,404
person,yolov8n,16433605163_8c9393beb1_z.jpg,480,640,3,1,0.813982248,161,188,33.54166667,29.375,426,614,319,480
person,yolov8n,16433605163_8c9393beb1_z.jpg,480,640,3,1,0.806271911,269,132,56.04166667,20.625,507,639,156,425
person,yolov8n,16433605163_8c9393beb1_z.jpg,480,640,3,1,0.792399406,213,64,44.375,10,333,397,160,373
person,yolov8n,16433605163_8c9393beb1_z.jpg,480,640,3,1,0.737893522,226,64,47.08333333,10,410,474,164,390
person,yolov8n,16433605163_8c9393beb1_z.jpg,480,640,3,1,0.705991268,155,57,32.29166667,8.90625,199,256,169,324
person,yolov8n,16433605163_8c9393beb1_z.jpg,480,640,3,1,0.675370753,234,103,48.75,16.09375,104,207,160,394
person,yolov8n,16433605163_8c9393beb1_z.jpg,480,640,3,1,0.505658984,130,44,27.08333333,6.875,279,323,162,292
person,yolov8n,16433605163_8c9393beb1_z.jpg,480,640,3,1,0.404211581,147,64,30.625,10,506,570,175,322
person,yolov8n,16433605163_8c9393beb1_z.jpg,480,640,3,1,0.326093733,40,16,8.333333333,2.5,0,16,169,209
person,yolov8n,16433605163_8c9393beb1_z.jpg,480,640,3,1,0.29608345,232,147,48.33333333,22.96875,104,251,161,393
person,yolov8n,15071673457_0703cea442_z.jpg,426,640,3,1,0.837977052,372,411,87.32394366,64.21875,98,509,49,421
person,yolov8n,300422857_eb3a885357_z.jpg,640,632,3,1,0.769249856,633,550,98.90625,87.02531646,36,586,6,639
person,yolov8n,2522213440_edbcb5ba05_z.jpg,428,639,3,1,0.936656833,384,291,89.71962617,45.5399061,247,538,39,423
person,yolov8n,2522213440_edbcb5ba05_z.jpg,428,639,3,1,0.697311819,93,236,21.72897196,36.93270736,403,639,331,424
person,yolov8n,2522213440_edbcb5ba05_z.jpg,428,639,3,1,0.454787582,229,154,53.5046729,24.10015649,485,639,171,400
person,yolov8n,2522213440_edbcb5ba05_z.jpg,428,639,3,1,0.348387659,326,157,76.1682243,24.56964006,482,639,72,398
person,yolov8n,6985531639_71621c1e69_z.jpg,427,640,3,1,0.888986409,419,626,98.1264637,97.8125,10,636,3,422
person,yolov8n,892497288_b916ec820e_z.jpg,481,640,3,1,0.708111346,389,375,80.87318087,58.59375,238,613,74,463
person,yolov8n,892497288_b916ec820e_z.jpg,481,640,3,1,0.681547582,64,40,13.30561331,6.25,0,40,21,85
person,yolov8n,892497288_b916ec820e_z.jpg,481,640,3,1,0.582989931,388,315,80.66528067,49.21875,0,315,1,389
person,yolov8n,892497288_b916ec820e_z.jpg,481,640,3,1,0.505376339,262,207,54.46985447,32.34375,230,437,41,303
person,yolov8n,892497288_b916ec820e_z.jpg,481,640,3,1,0.376585782,45,59,9.355509356,9.21875,13,72,39,84
person,yolov8n,892497288_b916ec820e_z.jpg,481,640,3,1,0.303112477,63,71,13.0977131,11.09375,1,72,21,84
person,yolov8n,892497288_b916ec820e_z.jpg,481,640,3,1,0.27999267,457,596,95.01039501,93.125,1,597,18,475
person,yolov8n,2767937261_724bce0179_z.jpg,480,640,3,1,0.950116515,400,303,83.33333333,47.34375,200,503,79,479
person,yolov8n,16104664631_cce4a9a58c_z.jpg,480,620,3,1,0.697789431,412,372,85.83333333,60,0,372,59,471
person,yolov8n,16104664631_cce4a9a58c_z.jpg,480,620,3,1,0.435148478,89,99,18.54166667,15.96774194,458,557,389,478
person,yolov8n,3954929491_6e95503c3d_z.jpg,420,640,3,1,0.879103899,198,114,47.14285714,17.8125,525,639,221,419
person,yolov8n,3954929491_6e95503c3d_z.jpg,420,640,3,1,0.869499087,206,94,49.04761905,14.6875,23,117,212,418
person,yolov8n,3954929491_6e95503c3d_z.jpg,420,640,3,1,0.747305572,190,92,45.23809524,14.375,108,200,228,418
person,yolov8n,3954929491_6e95503c3d_z.jpg,420,640,3,1,0.706116676,188,100,44.76190476,15.625,191,291,230,418
person,yolov8n,3954929491_6e95503c3d_z.jpg,420,640,3,1,0.568545163,192,111,45.71428571,17.34375,430,541,227,419
person,yolov8n,3954929491_6e95503c3d_z.jpg,420,640,3,1,0.512917578,178,81,42.38095238,12.65625,281,362,241,419
person,yolov8n,3954929491_6e95503c3d_z.jpg,420,640,3,1,0.316950321,145,66,34.52380952,10.3125,477,543,166,311
person,yolov8n,3954929491_6e95503c3d_z.jpg,420,640,3,1,0.29560715,179,110,42.61904762,17.1875,339,449,239,418
person,yolov8n,3954929491_6e95503c3d_z.jpg,420,640,3,1,0.287054896,137,69,32.61904762,10.78125,175,244,108,245
person,yolov8n,11983632613_4efcf5f3d3_z.jpg,402,640,3,1,0.86642158,204,74,50.74626866,11.5625,20,94,12,216
person,yolov8n,11983632613_4efcf5f3d3_z.jpg,402,640,3,1,0.863743603,174,409,43.28358209,63.90625,230,639,190,364
person,yolov8n,11983632613_4efcf5f3d3_z.jpg,402,640,3,1,0.843305767,77,45,19.15422886,7.03125,299,344,47,124
person,yolov8n,11983632613_4efcf5f3d3_z.jpg,402,640,3,1,0.784745157,118,31,29.35323383,4.84375,128,159,47,165
person,yolov8n,11983632613_4efcf5f3d3_z.jpg,402,640,3,1,0.779336214,87,36,21.64179104,5.625,474,510,34,121
person,yolov8n,11983632613_4efcf5f3d3_z.jpg,402,640,3,1,0.690550923,109,34,27.11442786,5.3125,344,378,21,130
person,yolov8n,11983632613_4efcf5f3d3_z.jpg,402,640,3,1,0.671561718,119,35,29.60199005,5.46875,81,116,50,169
person,yolov8n,11983632613_4efcf5f3d3_z.jpg,402,640,3,1,0.626007557,122,28,30.34825871,4.375,0,28,50,172
person,yolov8n,11983632613_4efcf5f3d3_z.jpg,402,640,3,1,0.60049504,81,25,20.14925373,3.90625,261,286,63,144
person,yolov8n,11983632613_4efcf5f3d3_z.jpg,402,640,3,1,0.500942171,121,38,30.09950249,5.9375,8,46,53,174
person,yolov8n,15625756039_d59f4e16fa_z.jpg,480,640,3,1,0.915066659,351,154,73.125,24.0625,25,179,129,480
person,yolov8n,15625756039_d59f4e16fa_z.jpg,480,640,3,1,0.903401256,403,171,83.95833333,26.71875,208,379,77,480
person,yolov8n,15625756039_d59f4e16fa_z.jpg,480,640,3,1,0.892128289,353,140,73.54166667,21.875,423,563,126,479
person,yolov8n,15625756039_d59f4e16fa_z.jpg,480,640,3,1,0.803984225,397,95,82.70833333,14.84375,360,455,82,479
person,yolov8n,6217890759_2a6a04d1d9_z.jpg,427,640,3,1,0.907281935,304,109,71.19437939,17.03125,457,566,95,399
person,yolov8n,6217890759_2a6a04d1d9_z.jpg,427,640,3,1,0.89822197,321,99,75.17564403,15.46875,308,407,58,379
person,yolov8n,6217890759_2a6a04d1d9_z.jpg,427,640,3,1,0.889518499,285,81,66.74473068,12.65625,390,471,97,382
person,yolov8n,6217890759_2a6a04d1d9_z.jpg,427,640,3,1,0.882877529,279,101,65.33957845,15.78125,149,250,93,372
person,yolov8n,6217890759_2a6a04d1d9_z.jpg,427,640,3,1,0.880128324,309,110,72.36533958,17.1875,59,169,104,413
person,yolov8n,6217890759_2a6a04d1d9_z.jpg,427,640,3,1,0.853959203,301,85,70.49180328,13.28125,232,317,71,372
person,yolov8n,3195432512_d0a96b2967_z.jpg,640,480,3,1,0.9091084,635,477,99.21875,99.375,1,478,2,637
person,yolov8n,16789366715_633121f7bb_z.jpg,640,457,3,1,0.916657507,635,389,99.21875,85.12035011,67,456,3,638
person,yolov8n,3442716929_7a26250063_z.jpg,640,427,3,1,0.929872632,579,427,90.46875,100,0,427,59,638
person,yolov8n,5943858783_a2cc450fb3_z.jpg,421,639,3,1,0.931268096,379,172,90.02375297,26.9170579,235,407,38,417
person,yolov8n,5943858783_a2cc450fb3_z.jpg,421,639,3,1,0.917885303,363,154,86.22327791,24.10015649,0,154,52,415
person,yolov8n,5943858783_a2cc450fb3_z.jpg,421,639,3,1,0.873110652,381,158,90.49881235,24.72613459,386,544,32,413
person,yolov8n,5943858783_a2cc450fb3_z.jpg,421,639,3,1,0.81131494,322,133,76.48456057,20.81377152,131,264,94,416
person,yolov8n,5425389979_390e3f3881_z.jpg,456,640,3,1,0.807331502,126,96,27.63157895,15,431,527,280,406
person,yolov8n,5425389979_390e3f3881_z.jpg,456,640,3,1,0.796248436,113,102,24.78070175,15.9375,538,640,301,414
person,yolov8n,5425389979_390e3f3881_z.jpg,456,640,3,1,0.795904994,175,94,38.37719298,14.6875,98,192,173,348
person,yolov8n,5425389979_390e3f3881_z.jpg,456,640,3,1,0.768376589,127,107,27.85087719,16.71875,128,235,273,400
person,yolov8n,5425389979_390e3f3881_z.jpg,456,640,3,1,0.735009015,166,94,36.40350877,14.6875,435,529,170,336
person,yolov8n,5425389979_390e3f3881_z.jpg,456,640,3,1,0.729673564,190,98,41.66666667,15.3125,510,608,179,369
person,yolov8n,5425389979_390e3f3881_z.jpg,456,640,3,1,0.7275787,216,102,47.36842105,15.9375,10,112,166,382
person,yolov8n,5425389979_390e3f3881_z.jpg,456,640,3,1,0.726877213,203,81,44.51754386,12.65625,189,270,160,363
person,yolov8n,5425389979_390e3f3881_z.jpg,456,640,3,1,0.712522984,124,119,27.19298246,18.59375,13,132,292,416
person,yolov8n,5425389979_390e3f3881_z.jpg,456,640,3,1,0.710007846,108,104,23.68421053,16.25,329,433,292,400
person,yolov8n,5425389979_390e3f3881_z.jpg,456,640,3,1,0.681153178,105,96,23.02631579,15,232,328,292,397
person,yolov8n,5425389979_390e3f3881_z.jpg,456,640,3,1,0.671497583,179,93,39.25438596,14.53125,352,445,177,356
person,yolov8n,5425389979_390e3f3881_z.jpg,456,640,3,1,0.619541764,121,86,26.53508772,13.4375,46,132,291,412
person,yolov8n,5425389979_390e3f3881_z.jpg,456,640,3,1,0.614149451,202,94,44.29824561,14.6875,266,360,151,353
person,yolov8n,5425389979_390e3f3881_z.jpg,456,640,3,1,0.565355778,147,78,32.23684211,12.1875,423,501,88,235
person,yolov8n,5425389979_390e3f3881_z.jpg,456,640,3,1,0.507612288,136,72,29.8245614,11.25,354,426,93,229
person,yolov8n,5425389979_390e3f3881_z.jpg,456,640,3,1,0.471041352,144,73,31.57894737,11.40625,496,569,99,243
person,yolov8n,5425389979_390e3f3881_z.jpg,456,640,3,1,0.376082182,127,73,27.85087719,11.40625,111,184,36,163
person,yolov8n,5425389979_390e3f3881_z.jpg,456,640,3,1,0.361592948,115,54,25.21929825,8.4375,402,456,52,167
person,yolov8n,5425389979_390e3f3881_z.jpg,456,640,3,1,0.352060795,130,77,28.50877193,12.03125,204,281,106,236
person,yolov8n,5425389979_390e3f3881_z.jpg,456,640,3,1,0.314922869,138,66,30.26315789,10.3125,76,142,101,239
person,yolov8n,5425389979_390e3f3881_z.jpg,456,640,3,1,0.278581619,134,70,29.38596491,10.9375,141,211,103,237
person,yolov8n,5425389979_390e3f3881_z.jpg,456,640,3,1,0.265891522,120,60,26.31578947,9.375,260,320,44,164
person,yolov8n,5425389979_390e3f3881_z.jpg,456,640,3,1,0.258549422,107,55,23.46491228,8.59375,329,384,45,152
person,yolov8n,5387089136_efcdc42456_z.jpg,431,640,3,1,0.912344575,343,94,79.58236659,14.6875,0,94,48,391
person,yolov8n,5387089136_efcdc42456_z.jpg,431,640,3,1,0.898063183,243,98,56.38051044,15.3125,495,593,185,428
person,yolov8n,5387089136_efcdc42456_z.jpg,431,640,3,1,0.897491276,370,100,85.84686775,15.625,540,640,53,423
person,yolov8n,5387089136_efcdc42456_z.jpg,431,640,3,1,0.885353446,264,98,61.25290023,15.3125,83,181,164,428
person,yolov8n,5387089136_efcdc42456_z.jpg,431,640,3,1,0.884368896,231,102,53.5962877,15.9375,401,503,196,427
person,yolov8n,5387089136_efcdc42456_z.jpg,431,640,3,1,0.877191961,229,100,53.13225058,15.625,238,338,197,426
person,yolov8n,5387089136_efcdc42456_z.jpg,431,640,3,1,0.863489687,244,90,56.612529,14.0625,331,421,186,430
person,yolov8n,5387089136_efcdc42456_z.jpg,431,640,3,1,0.847600996,229,85,53.13225058,13.28125,170,255,195,424
person,yolov8n,5387089136_efcdc42456_z.jpg,431,640,3,1,0.836914361,85,79,19.72157773,12.34375,298,377,7,92
person,yolov8n,5387089136_efcdc42456_z.jpg,431,640,3,1,0.752079248,174,80,40.3712297,12.5,78,158,68,242
person,yolov8n,5387089136_efcdc42456_z.jpg,431,640,3,1,0.682535887,59,83,13.68909513,12.96875,361,444,35,94
person,yolov8n,5387089136_efcdc42456_z.jpg,431,640,3,1,0.635466099,76,57,17.63341067,8.90625,480,537,29,105
person,yolov8n,5387089136_efcdc42456_z.jpg,431,640,3,1,0.627342105,156,70,36.19489559,10.9375,515,585,41,197
person,yolov8n,5387089136_efcdc42456_z.jpg,431,640,3,1,0.418765992,63,71,14.61716937,11.09375,229,300,30,93
person,yolov8n,5387089136_efcdc42456_z.jpg,431,640,3,1,0.336980075,64,36,14.84918794,5.625,48,84,69,133
person,yolov8n,5387089136_efcdc42456_z.jpg,431,640,3,1,0.322945327,111,63,25.75406032,9.84375,130,193,27,138
person,yolov8n,5387089136_efcdc42456_z.jpg,431,640,3,1,0.320439368,58,49,13.45707657,7.65625,249,298,32,90
person,yolov8n,3300269400_c276d7a1a7_z.jpg,469,639,3,1,0.936788738,458,612,97.65458422,95.77464789,24,636,6,464
person,yolov8n,528252616_a57e6257ff_z.jpg,480,640,3,1,0.923440456,354,224,73.75,35,416,640,125,479
person,yolov8n,528252616_a57e6257ff_z.jpg,480,640,3,1,0.883081377,332,171,69.16666667,26.71875,0,171,148,480
person,yolov8n,528252616_a57e6257ff_z.jpg,480,640,3,1,0.880919397,451,293,93.95833333,45.78125,208,501,29,480
person,yolov8n,6723753569_a1d8678cde_z.jpg,640,425,3,1,0.915538132,613,418,95.78125,98.35294118,0,418,27,640
person,yolov8n,201365540_d1af73d7cd_z.jpg,640,482,3,1,0.803727925,527,477,82.34375,98.9626556,4,481,113,640
person,yolov8n,15091650494_d8a5f37637_z.jpg,640,427,3,1,0.943871379,583,424,91.09375,99.29742389,1,425,55,638
person,yolov8n,2365652301_0de626bd97_z.jpg,498,640,3,1,0.914623022,351,122,70.48192771,19.0625,392,514,73,424
person,yolov8n,2365652301_0de626bd97_z.jpg,498,640,3,1,0.879025877,308,145,61.84738956,22.65625,225,370,115,423
person,yolov8n,8960442702_6c931904f0_z.jpg,427,640,3,1,0.91336596,416,183,97.42388759,28.59375,82,265,6,422
person,yolov8n,8960442702_6c931904f0_z.jpg,427,640,3,1,0.889371037,422,227,98.82903981,35.46875,267,494,0,422
person,yolov8n,5594762666_e157f338f0_z.jpg,425,640,3,1,0.964123607,394,294,92.70588235,45.9375,345,639,26,420
person,yolov8n,5594762666_e157f338f0_z.jpg,425,640,3,1,0.883590817,372,322,87.52941176,50.3125,0,322,50,422
person,yolov8n,7192116992_5447de0caa_z.jpg,640,480,3,1,0.831119239,602,473,94.0625,98.54166667,6,479,35,637
person,yolov8n,8562326627_1a68052e58_z.jpg,640,582,3,1,0.76895225,635,576,99.21875,98.96907216,6,582,2,637
person,yolov8n,4380790081_1cbcb573ec_z.jpg,421,640,3,1,0.860707641,374,607,88.83610451,94.84375,0,607,40,414
person,yolov8n,15392489891_905432249f_z.jpg,427,640,3,1,0.955650151,293,191,68.61826698,29.84375,63,254,0,293
person,yolov8n,15392489891_905432249f_z.jpg,427,640,3,1,0.833490014,243,185,56.90866511,28.90625,337,522,180,423
person,yolov8n,15392489891_905432249f_z.jpg,427,640,3,1,0.809447169,236,221,55.26932084,34.53125,124,345,161,397
person,yolov8n,15392489891_905432249f_z.jpg,427,640,3,1,0.609488368,104,80,24.3559719,12.5,349,429,146,250
person,yolov8n,15392489891_905432249f_z.jpg,427,640,3,1,0.591555476,56,47,13.1147541,7.34375,241,288,132,188
person,yolov8n,15392489891_905432249f_z.jpg,427,640,3,1,0.344910145,113,117,26.46370023,18.28125,347,464,180,293
person,yolov8n,4479906928_4ab0604d1c_z.jpg,640,480,3,1,0.821309805,639,442,99.84375,92.08333333,37,479,0,639
person,yolov8n,2392419690_8495e2b2c9_z.jpg,496,640,3,1,0.896839201,240,201,48.38709677,31.40625,324,525,2,242
person,yolov8n,2392419690_8495e2b2c9_z.jpg,496,640,3,1,0.851966977,240,226,48.38709677,35.3125,3,229,250,490
person,yolov8n,2392419690_8495e2b2c9_z.jpg,496,640,3,1,0.849399209,239,257,48.18548387,40.15625,5,262,4,243
person,yolov8n,2392419690_8495e2b2c9_z.jpg,496,640,3,1,0.779880106,241,161,48.58870968,25.15625,323,484,249,490
person,yolov8n,2392419690_8495e2b2c9_z.jpg,496,640,3,1,0.669822514,77,61,15.52419355,9.53125,15,76,251,328
person,yolov8n,2392419690_8495e2b2c9_z.jpg,496,640,3,1,0.538054645,182,206,36.69354839,32.1875,420,626,310,492
person,yolov8n,2392419690_8495e2b2c9_z.jpg,496,640,3,1,0.34545511,114,164,22.98387097,25.625,424,588,129,243
person,yolov8n,8538565946_199e28b584_z.jpg,612,612,3,1,0.877233803,601,553,98.20261438,90.35947712,46,599,11,612
person,yolov8n,15083791924_c7195faca3_z.jpg,428,640,3,1,0.921846449,423,405,98.8317757,63.28125,44,449,0,423
person,yolov8n,8922688952_9cacbffe29_z.jpg,639,402,3,1,0.675055683,639,402,100,100,0,402,0,639
person,yolov8n,8922688952_9cacbffe29_z.jpg,639,402,3,1,0.586010516,632,266,98.90453834,66.16915423,0,266,3,635
person,yolov8n,5540859766_5596c9c59e_z.jpg,520,600,3,1,0.894316256,476,574,91.53846154,95.66666667,1,575,40,516
person,yolov8n,5540859766_5596c9c59e_z.jpg,520,600,3,1,0.482977033,384,445,73.84615385,74.16666667,130,575,130,514
person,yolov8n,5826499075_8c91ec270b_z.jpg,640,478,3,0,0,0,0,0,0,0,0,0,0
person,yolov8n,4728907141_f9e5aa4bce_z.jpg,480,640,3,1,0.921833277,322,209,67.08333333,32.65625,182,391,58,380
person,yolov8n,4728907141_f9e5aa4bce_z.jpg,480,640,3,1,0.870119512,180,107,37.5,16.71875,0,107,23,203
person,yolov8n,4728907141_f9e5aa4bce_z.jpg,480,640,3,1,0.79155302,163,101,33.95833333,15.78125,486,587,19,182
person,yolov8n,5316877862_ccdebd50e5_z.jpg,419,639,3,1,0.928858221,381,350,90.93078759,54.77308294,289,639,34,415
person,yolov8n,5316877862_ccdebd50e5_z.jpg,419,639,3,1,0.917960048,382,243,91.16945107,38.02816901,13,256,33,415
person,yolov8n,5316877862_ccdebd50e5_z.jpg,419,639,3,1,0.836719036,404,91,96.42004773,14.24100156,0,91,0,404
person,yolov8n,5316877862_ccdebd50e5_z.jpg,419,639,3,1,0.319333375,216,35,51.55131265,5.477308294,242,277,200,416
person,yolov8n,15543230406_71c5a59208_z.jpg,463,640,3,1,0.792953491,362,410,78.18574514,64.0625,230,640,97,459
person,yolov8n,15543230406_71c5a59208_z.jpg,463,640,3,1,0.764609277,434,209,93.73650108,32.65625,0,209,23,457
person,yolov8n,15543230406_71c5a59208_z.jpg,463,640,3,1,0.582629144,362,250,78.18574514,39.0625,225,475,93,455
person,yolov8n,15543230406_71c5a59208_z.jpg,463,640,3,1,0.363254189,379,284,81.8574514,44.375,0,284,23,402
person,yolov8n,6431185703_6c72dd7b5e_z.jpg,427,640,3,1,0.715158939,94,68,22.01405152,10.625,551,619,208,302
person,yolov8n,6431185703_6c72dd7b5e_z.jpg,427,640,3,1,0.631783724,105,48,24.59016393,7.5,492,540,212,317
person,yolov8n,6431185703_6c72dd7b5e_z.jpg,427,640,3,1,0.605510056,90,32,21.07728337,5,160,192,216,306
person,yolov8n,6431185703_6c72dd7b5e_z.jpg,427,640,3,1,0.601956069,113,36,26.46370023,5.625,223,259,206,319
person,yolov8n,6431185703_6c72dd7b5e_z.jpg,427,640,3,1,0.569536984,164,68,38.40749415,10.625,347,415,188,352
person,yolov8n,6431185703_6c72dd7b5e_z.jpg,427,640,3,1,0.568624198,157,71,36.76814988,11.09375,424,495,182,339
person,yolov8n,6431185703_6c72dd7b5e_z.jpg,427,640,3,1,0.514730811,132,50,30.91334895,7.8125,299,349,208,340
person,yolov8n,6431185703_6c72dd7b5e_z.jpg,427,640,3,1,0.491146713,161,99,37.70491803,15.46875,395,494,179,340
person,yolov8n,6431185703_6c72dd7b5e_z.jpg,427,640,3,1,0.438264817,100,31,23.41920375,4.84375,184,215,188,288
person,yolov8n,6431185703_6c72dd7b5e_z.jpg,427,640,3,1,0.421031803,95,33,22.24824356,5.15625,89,122,196,291
person,yolov8n,6431185703_6c72dd7b5e_z.jpg,427,640,3,1,0.382087141,68,26,15.92505855,4.0625,44,70,210,278
person,yolov8n,6431185703_6c72dd7b5e_z.jpg,427,640,3,1,0.343676507,97,34,22.71662763,5.3125,124,158,203,300
person,yolov8n,6431185703_6c72dd7b5e_z.jpg,427,640,3,1,0.284400403,78,22,18.26697892,3.4375,68,90,206,284
person,yolov8n,6431185703_6c72dd7b5e_z.jpg,427,640,3,1,0.276486427,103,50,24.12177986,7.8125,470,520,183,286
person,yolov8s,6499183869_45bb8908c3_z.jpg,640,427,3,1,0.953504801,585,426,91.40625,99.76580796,1,427,54,639
person,yolov8s,3409776362_07a8bb7f17_z.jpg,523,640,3,1,0.858038366,495,437,94.64627151,68.28125,82,519,24,519
person,yolov8s,8399932836_19c21d3779_z.jpg,640,524,3,1,0.920940638,573,416,89.53125,79.38931298,99,515,53,626
person,yolov8s,8349516772_6928ba8b88_z.jpg,480,640,3,1,0.894428432,433,510,90.20833333,79.6875,2,512,40,473
person,yolov8s,738798561_2d54b53ec5_z.jpg,640,480,3,1,0.886004388,570,429,89.0625,89.375,34,463,54,624
person,yolov8s,4282546783_10b5e0a62e_z.jpg,480,640,3,1,0.942534745,477,183,99.375,28.59375,0,183,0,477
person,yolov8s,4282546783_10b5e0a62e_z.jpg,480,640,3,1,0.889408529,397,145,82.70833333,22.65625,217,362,83,480
person,yolov8s,4282546783_10b5e0a62e_z.jpg,480,640,3,1,0.85047698,267,89,55.625,13.90625,388,477,162,429
person,yolov8s,4282546783_10b5e0a62e_z.jpg,480,640,3,1,0.781097114,331,88,68.95833333,13.75,313,401,134,465
person,yolov8s,4282546783_10b5e0a62e_z.jpg,480,640,3,1,0.769652784,198,95,41.25,14.84375,138,233,260,458
person,yolov8s,4282546783_10b5e0a62e_z.jpg,480,640,3,1,0.589754581,210,51,43.75,7.96875,456,507,189,399
person,yolov8s,4282546783_10b5e0a62e_z.jpg,480,640,3,1,0.562636316,112,42,23.33333333,6.5625,576,618,254,366
person,yolov8s,4282546783_10b5e0a62e_z.jpg,480,640,3,1,0.524710298,138,43,28.75,6.71875,514,557,243,381
person,yolov8s,4282546783_10b5e0a62e_z.jpg,480,640,3,1,0.306658834,48,30,10,4.6875,536,566,240,288
person,yolov8s,4282546783_10b5e0a62e_z.jpg,480,640,3,1,0.276360244,79,19,16.45833333,2.96875,621,640,275,354
person,yolov8s,7166182137_a5679c9fa4_z.jpg,640,427,3,1,0.941925645,545,340,85.15625,79.62529274,14,354,92,637
person,yolov8s,4386974407_c2915fa9b1_z.jpg,639,457,3,1,0.938122809,417,173,65.25821596,37.85557987,141,314,96,513
person,yolov8s,6881088206_947a7622d4_z.jpg,640,480,3,1,0.933618486,469,281,73.28125,58.54166667,139,420,92,561
person,yolov8s,6881088206_947a7622d4_z.jpg,640,480,3,1,0.888070643,323,130,50.46875,27.08333333,1,131,316,639
person,yolov8s,8874948232_195679aa4e_z.jpg,427,640,3,1,0.906144559,410,242,96.01873536,37.8125,287,529,9,419
person,yolov8s,8874948232_195679aa4e_z.jpg,427,640,3,1,0.87224853,234,103,54.80093677,16.09375,467,570,114,348
person,yolov8s,8874948232_195679aa4e_z.jpg,427,640,3,1,0.867656112,350,311,81.96721311,48.59375,1,312,73,423
person,yolov8s,8874948232_195679aa4e_z.jpg,427,640,3,1,0.834612608,192,177,44.96487119,27.65625,463,640,1,193
person,yolov8s,8874948232_195679aa4e_z.jpg,427,640,3,1,0.833731294,138,88,32.31850117,13.75,552,640,161,299
person,yolov8s,8874948232_195679aa4e_z.jpg,427,640,3,1,0.80476439,171,233,40.04683841,36.40625,179,412,253,424
person,yolov8s,8874948232_195679aa4e_z.jpg,427,640,3,1,0.66254288,320,205,74.94145199,32.03125,0,205,102,422
person,yolov8s,8874948232_195679aa4e_z.jpg,427,640,3,1,0.591206789,148,41,34.66042155,6.40625,599,640,18,166
person,yolov8s,8874948232_195679aa4e_z.jpg,427,640,3,1,0.504979193,142,119,33.25526932,18.59375,521,640,281,423
person,yolov8s,8874948232_195679aa4e_z.jpg,427,640,3,1,0.2996144,169,335,39.57845433,52.34375,179,514,254,423
person,yolov8s,202416281_527efb7418_z.jpg,639,469,3,1,0.861363769,466,209,72.92644757,44.56289979,169,378,128,594
person,yolov8s,5605719660_5bed05cca3_z.jpg,425,640,3,1,0.931649446,418,402,98.35294118,62.8125,237,639,0,418
person,yolov8s,5605719660_5bed05cca3_z.jpg,425,640,3,1,0.917362213,406,249,95.52941176,38.90625,1,250,14,420
person,yolov8s,16850385890_8105762655_z.jpg,640,425,3,1,0.804887295,602,417,94.0625,98.11764706,8,425,35,637
person,yolov8s,98052295_1221189a77_z.jpg,534,640,3,1,0.90746814,528,634,98.87640449,99.0625,2,636,0,528
person,yolov8s,4030862073_d697f506b0_z.jpg,601,640,3,1,0.871821761,574,364,95.50748752,56.875,275,639,24,598
person,yolov8s,4030862073_d697f506b0_z.jpg,601,640,3,1,0.858258128,544,339,90.51580699,52.96875,4,343,51,595
person,yolov8s,2768961204_712996d2bd_z.jpg,639,355,3,1,0.914694846,502,218,78.56025039,61.4084507,101,319,116,618
person,yolov8s,15983066535_629c335c63_z.jpg,427,640,3,1,0.942304254,400,465,93.67681499,72.65625,112,577,22,422
person,yolov8s,2946145533_75f5268f19_z.jpg,480,640,3,1,0.71073842,478,629,99.58333333,98.28125,1,630,0,478
person,yolov8s,8744937858_81c17befae_z.jpg,640,426,3,1,0.916994691,483,305,75.46875,71.59624413,61,366,62,545
person,yolov8s,8183126241_e78c7f86ba_z.jpg,425,640,3,1,0.957083046,415,325,97.64705882,50.78125,5,330,6,421
person,yolov8s,8183126241_e78c7f86ba_z.jpg,425,640,3,1,0.867374778,379,241,89.17647059,37.65625,340,581,42,421
person,yolov8s,8183126241_e78c7f86ba_z.jpg,425,640,3,1,0.695990443,199,62,46.82352941,9.6875,550,612,222,421
person,yolov8s,8183126241_e78c7f86ba_z.jpg,425,640,3,1,0.350324243,137,29,32.23529412,4.53125,0,29,285,422
person,yolov8s,16954781749_4c32123444_z.jpg,427,640,3,1,0.936107695,336,212,78.68852459,33.125,138,350,86,422
person,yolov8s,16954781749_4c32123444_z.jpg,427,640,3,1,0.929442406,328,202,76.81498829,31.5625,335,537,94,422
person,yolov8s,7581740758_a1c5cf246e_z.jpg,640,427,3,1,0.949479103,545,406,85.15625,95.08196721,2,408,93,638
person,yolov8s,5298850167_d1e13e9551_z.jpg,391,640,3,1,0.922796845,331,299,84.65473146,46.71875,1,300,54,385
person,yolov8s,5298850167_d1e13e9551_z.jpg,391,640,3,1,0.813303173,319,353,81.58567775,55.15625,125,478,66,385
person,yolov8s,5298850167_d1e13e9551_z.jpg,391,640,3,1,0.791725576,255,140,65.2173913,21.875,0,140,52,307
person,yolov8s,5298850167_d1e13e9551_z.jpg,391,640,3,1,0.643690705,351,266,89.76982097,41.5625,374,640,27,378
person,yolov8s,4901520304_aa5c10705e_z.jpg,480,640,3,1,0.92175293,479,615,99.79166667,96.09375,6,621,0,479
person,yolov8s,4901520304_aa5c10705e_z.jpg,480,640,3,1,0.372791857,71,74,14.79166667,11.5625,0,74,164,235
person,yolov8s,14507981482_c50d893620_z.jpg,640,503,3,1,0.892075896,463,144,72.34375,28.62823062,35,179,107,570
person,yolov8s,14507981482_c50d893620_z.jpg,640,503,3,1,0.84221071,281,91,43.90625,18.09145129,361,452,337,618
person,yolov8s,14507981482_c50d893620_z.jpg,640,503,3,1,0.808611035,412,125,64.375,24.85089463,135,260,65,477
person,yolov8s,14507981482_c50d893620_z.jpg,640,503,3,1,0.769968748,392,86,61.25,17.09741551,403,489,51,443
person,yolov8s,14507981482_c50d893620_z.jpg,640,503,3,1,0.756912172,512,158,80,31.41153082,196,354,109,621
person,yolov8s,14507981482_c50d893620_z.jpg,640,503,3,1,0.659423888,365,148,57.03125,29.42345924,322,470,95,460
person,yolov8s,14507981482_c50d893620_z.jpg,640,503,3,1,0.607719958,470,166,73.4375,33.00198807,315,481,94,564
person,yolov8s,14507981482_c50d893620_z.jpg,640,503,3,1,0.470866024,110,52,17.1875,10.33797217,116,168,59,169
person,yolov8s,14507981482_c50d893620_z.jpg,640,503,3,1,0.461640894,106,46,16.5625,9.145129225,322,368,69,175
person,yolov8s,7742706992_27215ef7f8_z.jpg,640,428,3,1,0.89169997,527,325,82.34375,75.93457944,83,408,112,639
person,yolov8s,7742706992_27215ef7f8_z.jpg,640,428,3,1,0.692371488,336,180,52.5,42.05607477,232,412,44,380
person,yolov8s,7742706992_27215ef7f8_z.jpg,640,428,3,1,0.675307989,128,89,20,20.79439252,1,90,511,639
person,yolov8s,7742706992_27215ef7f8_z.jpg,640,428,3,1,0.511900783,176,30,27.5,7.009345794,397,427,164,340
person,yolov8s,7742706992_27215ef7f8_z.jpg,640,428,3,1,0.418861747,527,181,82.34375,42.28971963,232,413,44,571
person,yolov8s,11132512636_ebb3a6a070_z.jpg,427,640,3,1,0.903694272,340,172,79.62529274,26.875,392,564,71,411
person,yolov8s,11132512636_ebb3a6a070_z.jpg,427,640,3,1,0.86122793,239,74,55.97189696,11.5625,321,395,146,385
person,yolov8s,11132512636_ebb3a6a070_z.jpg,427,640,3,1,0.809267521,304,133,71.19437939,20.78125,196,329,89,393
person,yolov8s,11132512636_ebb3a6a070_z.jpg,427,640,3,1,0.720724583,258,124,60.42154567,19.375,59,183,120,378
person,yolov8s,11132512636_ebb3a6a070_z.jpg,427,640,3,1,0.574664176,208,53,48.71194379,8.28125,165,218,167,375
person,yolov8s,7843905188_07e5d2a569_z.jpg,425,640,3,1,0.941239536,405,328,95.29411765,51.25,311,639,14,419
person,yolov8s,7843905188_07e5d2a569_z.jpg,425,640,3,1,0.931566894,346,350,81.41176471,54.6875,1,351,74,420
person,yolov8s,189076128_ee6f694a30_z.jpg,640,428,3,1,0.869460225,579,427,90.46875,99.76635514,1,428,60,639
person,yolov8s,189076128_ee6f694a30_z.jpg,640,428,3,1,0.258923322,126,67,19.6875,15.65420561,361,428,512,638
person,yolov8s,6098643678_fc8044b5ac_z.jpg,427,640,3,1,0.951240957,367,260,85.94847775,40.625,380,640,55,422
person,yolov8s,6098643678_fc8044b5ac_z.jpg,427,640,3,1,0.915930212,320,241,74.94145199,37.65625,1,242,103,423
person,yolov8s,6098643678_fc8044b5ac_z.jpg,427,640,3,1,0.898874879,280,230,65.57377049,35.9375,236,466,143,423
person,yolov8s,2534669669_0c1d10c3e6_z.jpg,480,640,3,1,0.873013616,477,529,99.375,82.65625,1,530,1,478
person,yolov8s,5210291488_fe9939bdf1_z.jpg,360,640,3,1,0.84082824,179,64,49.72222222,10,318,382,114,293
person,yolov8s,5210291488_fe9939bdf1_z.jpg,360,640,3,1,0.839179277,160,65,44.44444444,10.15625,367,432,136,296
person,yolov8s,5210291488_fe9939bdf1_z.jpg,360,640,3,1,0.838506877,176,64,48.88888889,10,150,214,112,288
person,yolov8s,5210291488_fe9939bdf1_z.jpg,360,640,3,1,0.835669935,167,81,46.38888889,12.65625,435,516,133,300
person,yolov8s,5210291488_fe9939bdf1_z.jpg,360,640,3,1,0.814488947,106,52,29.44444444,8.125,518,570,152,258
person,yolov8s,5210291488_fe9939bdf1_z.jpg,360,640,3,1,0.803325236,167,62,46.38888889,9.6875,260,322,125,292
person,yolov8s,5210291488_fe9939bdf1_z.jpg,360,640,3,1,0.763582766,172,59,47.77777778,9.21875,206,265,116,288
person,yolov8s,5210291488_fe9939bdf1_z.jpg,360,640,3,1,0.7273072,160,56,44.44444444,8.75,38,94,120,280
person,yolov8s,5210291488_fe9939bdf1_z.jpg,360,640,3,1,0.677807271,153,52,42.5,8.125,94,146,132,285
person,yolov8s,5210291488_fe9939bdf1_z.jpg,360,640,3,1,0.500109673,170,68,47.22222222,10.625,78,146,114,284
person,yolov8s,5210291488_fe9939bdf1_z.jpg,360,640,3,1,0.472888678,53,35,14.72222222,5.46875,260,295,105,158
person,yolov8s,5210291488_fe9939bdf1_z.jpg,360,640,3,1,0.403764665,165,64,45.83333333,10,576,640,162,327
person,yolov8s,4083309359_020d325f73_z.jpg,640,427,3,1,0.939511597,608,427,95,100,0,427,31,639
person,yolov8s,8031274301_1d9bc9b665_z.jpg,640,427,3,1,0.904023826,573,334,89.53125,78.22014052,0,334,65,638
person,yolov8s,8031274301_1d9bc9b665_z.jpg,640,427,3,1,0.82789582,637,183,99.53125,42.85714286,242,425,0,637
person,yolov8s,5481347426_620620145e_z.jpg,427,640,3,1,0.950522244,388,162,90.86651054,25.3125,0,162,34,422
person,yolov8s,5481347426_620620145e_z.jpg,427,640,3,1,0.93812567,384,228,89.92974239,35.625,198,426,38,422
person,yolov8s,5481347426_620620145e_z.jpg,427,640,3,1,0.91195339,235,105,55.03512881,16.40625,515,620,188,423
person,yolov8s,5481347426_620620145e_z.jpg,427,640,3,1,0.908813834,248,85,58.07962529,13.28125,455,540,176,424
person,yolov8s,5481347426_620620145e_z.jpg,427,640,3,1,0.702767849,140,62,32.78688525,9.6875,390,452,233,373
person,yolov8s,5481347426_620620145e_z.jpg,427,640,3,1,0.641531765,208,33,48.71194379,5.15625,607,640,210,418
person,yolov8s,5481347426_620620145e_z.jpg,427,640,3,1,0.588235199,271,70,63.46604215,10.9375,109,179,153,424
person,yolov8s,5481347426_620620145e_z.jpg,427,640,3,1,0.565300345,307,91,71.8969555,14.21875,198,289,116,423
person,yolov8s,5481347426_620620145e_z.jpg,427,640,3,1,0.54347688,202,21,47.30679157,3.28125,619,640,215,417
person,yolov8s,5481347426_620620145e_z.jpg,427,640,3,1,0.43410489,55,44,12.88056206,6.875,258,302,84,139
person,yolov8s,5481347426_620620145e_z.jpg,427,640,3,1,0.395224094,113,85,26.46370023,13.28125,202,287,121,234
person,yolov8s,5513074265_5b31a2339b_z.jpg,428,639,3,1,0.894380748,424,504,99.06542056,78.87323944,3,507,0,424
person,yolov8s,5513074265_5b31a2339b_z.jpg,428,639,3,1,0.420037806,417,282,97.42990654,44.1314554,2,284,5,422
person,yolov8s,10921149963_027e750820_z.jpg,425,640,3,1,0.923915863,331,207,77.88235294,32.34375,433,640,88,419
person,yolov8s,10921149963_027e750820_z.jpg,425,640,3,1,0.537537932,280,366,65.88235294,57.1875,201,567,122,402
person,yolov8s,10921149963_027e750820_z.jpg,425,640,3,1,0.525841832,333,528,78.35294118,82.5,1,529,70,403
person,yolov8s,10921149963_027e750820_z.jpg,425,640,3,1,0.503915966,215,222,50.58823529,34.6875,199,421,124,339
person,yolov8s,268134569_0cea602ccb_z.jpg,480,640,3,1,0.880176485,472,371,98.33333333,57.96875,266,637,7,479
person,yolov8s,268134569_0cea602ccb_z.jpg,480,640,3,1,0.728972316,292,360,60.83333333,56.25,1,361,188,480
person,yolov8s,268134569_0cea602ccb_z.jpg,480,640,3,1,0.654685259,345,291,71.875,45.46875,349,640,0,345
person,yolov8s,268134569_0cea602ccb_z.jpg,480,640,3,1,0.56536001,437,274,91.04166667,42.8125,29,303,1,438
person,yolov8s,7163490183_0dff14b5d6_z.jpg,360,640,3,1,0.769305289,348,272,96.66666667,42.5,38,310,7,355
person,yolov8s,8488918795_f8ba7dabb6_z.jpg,594,471,3,1,0.926301718,478,146,80.47138047,30.99787686,7,153,98,576
person,yolov8s,8488918795_f8ba7dabb6_z.jpg,594,471,3,1,0.85819447,474,130,79.7979798,27.60084926,304,434,91,565
person,yolov8s,8488918795_f8ba7dabb6_z.jpg,594,471,3,1,0.82289046,488,146,82.15488215,30.99787686,152,298,82,570
person,yolov8s,1444579876_8c02edf580_z.jpg,639,483,3,1,0.929997265,603,462,94.36619718,95.65217391,0,462,27,630
person,yolov8s,6111783458_61cc1f0f88_z.jpg,640,425,3,1,0.931931674,624,424,97.5,99.76470588,0,424,14,638
person,yolov8s,10915137264_e8c23d54b4_z.jpg,639,428,3,1,0.885666907,473,312,74.02190923,72.89719626,52,364,165,638
person,yolov8s,4029738064_00c4cd038b_z.jpg,425,640,3,1,0.926213801,347,277,81.64705882,43.28125,46,323,74,421
person,yolov8s,6309741882_b074ee1a96_z.jpg,541,640,3,1,0.744799733,317,290,58.59519409,45.3125,1,291,215,532
person,yolov8s,6309741882_b074ee1a96_z.jpg,541,640,3,1,0.477366894,534,623,98.70609982,97.34375,13,636,0,534
person,yolov8s,6309741882_b074ee1a96_z.jpg,541,640,3,1,0.315178245,528,402,97.59704251,62.8125,237,639,0,528
person,yolov8s,8572756223_94130c5e61_z.jpg,481,640,3,1,0.924993694,458,334,95.21829522,52.1875,303,637,18,476
person,yolov8s,8572756223_94130c5e61_z.jpg,481,640,3,1,0.907067776,466,346,96.88149688,54.0625,0,346,7,473
person,yolov8s,16658372825_affc436763_z.jpg,640,369,3,1,0.899965942,393,160,61.40625,43.3604336,101,261,123,516
person,yolov8s,5298849761_aeeed1a3f9_z.jpg,640,425,3,1,0.889062822,628,423,98.125,99.52941176,0,423,10,638
person,yolov8s,16433605163_8c9393beb1_z.jpg,480,640,3,1,0.903968036,162,176,33.75,27.5,426,602,318,480
person,yolov8s,16433605163_8c9393beb1_z.jpg,480,640,3,1,0.862135708,234,160,48.75,25,100,260,160,394
person,yolov8s,16433605163_8c9393beb1_z.jpg,480,640,3,1,0.827583075,174,67,36.25,10.46875,41,108,152,326
person,yolov8s,16433605163_8c9393beb1_z.jpg,480,640,3,1,0.779035985,217,62,45.20833333,9.6875,332,394,160,377
person,yolov8s,16433605163_8c9393beb1_z.jpg,480,640,3,1,0.77391994,254,84,52.91666667,13.125,450,534,158,412
person,yolov8s,16433605163_8c9393beb1_z.jpg,480,640,3,1,0.729014099,292,104,60.83333333,16.25,536,640,154,446
person,yolov8s,16433605163_8c9393beb1_z.jpg,480,640,3,1,0.713997185,135,46,28.125,7.1875,278,324,161,296
person,yolov8s,16433605163_8c9393beb1_z.jpg,480,640,3,1,0.696397841,223,62,46.45833333,9.6875,409,471,165,388
person,yolov8s,16433605163_8c9393beb1_z.jpg,480,640,3,1,0.690222621,157,51,32.70833333,7.96875,198,249,167,324
person,yolov8s,16433605163_8c9393beb1_z.jpg,480,640,3,1,0.62469995,41,17,8.541666667,2.65625,0,17,167,208
person,yolov8s,16433605163_8c9393beb1_z.jpg,480,640,3,1,0.415835172,147,66,30.625,10.3125,504,570,176,323
person,yolov8s,16433605163_8c9393beb1_z.jpg,480,640,3,1,0.413201511,37,25,7.708333333,3.90625,141,166,165,202
person,yolov8s,16433605163_8c9393beb1_z.jpg,480,640,3,1,0.30335322,36,25,7.5,3.90625,17,42,170,206
person,yolov8s,16433605163_8c9393beb1_z.jpg,480,640,3,1,0.274665624,98,46,20.41666667,7.1875,594,640,147,245
person,yolov8s,16433605163_8c9393beb1_z.jpg,480,640,3,1,0.270416558,111,27,23.125,4.21875,270,297,170,281
person,yolov8s,15071673457_0703cea442_z.jpg,426,640,3,1,0.880541325,374,411,87.79342723,64.21875,102,513,48,422
person,yolov8s,300422857_eb3a885357_z.jpg,640,632,3,1,0.91770947,634,578,99.0625,91.4556962,52,630,4,638
person,yolov8s,2522213440_edbcb5ba05_z.jpg,428,639,3,1,0.944103539,384,290,89.71962617,45.38341158,247,537,39,423
person,yolov8s,2522213440_edbcb5ba05_z.jpg,428,639,3,1,0.741521835,94,235,21.96261682,36.77621283,404,639,331,425
person,yolov8s,2522213440_edbcb5ba05_z.jpg,428,639,3,1,0.507622898,222,155,51.86915888,24.25665102,484,639,171,393
person,yolov8s,2522213440_edbcb5ba05_z.jpg,428,639,3,1,0.339091867,322,155,75.23364486,24.25665102,484,639,73,395
person,yolov8s,2522213440_edbcb5ba05_z.jpg,428,639,3,1,0.281186402,175,67,40.88785047,10.48513302,6,73,44,219
person,yolov8s,6985531639_71621c1e69_z.jpg,427,640,3,1,0.924689651,421,590,98.59484778,92.1875,45,635,1,422
person,yolov8s,892497288_b916ec820e_z.jpg,481,640,3,1,0.889811397,349,314,72.55717256,49.0625,0,314,1,350
person,yolov8s,892497288_b916ec820e_z.jpg,481,640,3,1,0.736667335,263,196,54.67775468,30.625,239,435,39,302
person,yolov8s,892497288_b916ec820e_z.jpg,481,640,3,1,0.726866007,391,370,81.28898129,57.8125,240,610,74,465
person,yolov8s,892497288_b916ec820e_z.jpg,481,640,3,1,0.587600172,64,44,13.30561331,6.875,0,44,21,85
person,yolov8s,892497288_b916ec820e_z.jpg,481,640,3,1,0.370609045,168,391,34.92723493,61.09375,194,585,288,456
person,yolov8s,892497288_b916ec820e_z.jpg,481,640,3,1,0.279575884,65,71,13.51351351,11.09375,1,72,20,85
person,yolov8s,2767937261_724bce0179_z.jpg,480,640,3,1,0.958533168,401,303,83.54166667,47.34375,201,504,79,480
person,yolov8s,16104664631_cce4a9a58c_z.jpg,480,620,3,1,0.845533609,423,373,88.125,60.16129032,1,374,49,472
person,yolov8s,3954929491_6e95503c3d_z.jpg,420,640,3,1,0.89845401,206,93,49.04761905,14.53125,23,116,211,417
person,yolov8s,3954929491_6e95503c3d_z.jpg,420,640,3,1,0.886778891,198,115,47.14285714,17.96875,524,639,220,418
person,yolov8s,3954929491_6e95503c3d_z.jpg,420,640,3,1,0.831423521,189,93,45,14.53125,107,200,229,418
person,yolov8s,3954929491_6e95503c3d_z.jpg,420,640,3,1,0.799722373,186,99,44.28571429,15.46875,191,290,231,417
person,yolov8s,3954929491_6e95503c3d_z.jpg,420,640,3,1,0.719599426,191,114,45.47619048,17.8125,427,541,227,418
person,yolov8s,3954929491_6e95503c3d_z.jpg,420,640,3,1,0.42904523,148,66,35.23809524,10.3125,478,544,161,309
person,yolov8s,3954929491_6e95503c3d_z.jpg,420,640,3,1,0.369974822,180,112,42.85714286,17.5,337,449,238,418
person,yolov8s,3954929491_6e95503c3d_z.jpg,420,640,3,1,0.334832937,115,85,27.38095238,13.28125,212,297,188,303
person,yolov8s,3954929491_6e95503c3d_z.jpg,420,640,3,1,0.312650144,187,90,44.52380952,14.0625,92,182,96,283
person,yolov8s,3954929491_6e95503c3d_z.jpg,420,640,3,1,0.310194224,111,77,26.42857143,12.03125,293,370,188,299
person,yolov8s,3954929491_6e95503c3d_z.jpg,420,640,3,1,0.302179247,138,67,32.85714286,10.46875,177,244,105,243
person,yolov8s,3954929491_6e95503c3d_z.jpg,420,640,3,1,0.283035666,112,94,26.66666667,14.6875,124,218,183,295
person,yolov8s,11983632613_4efcf5f3d3_z.jpg,402,640,3,1,0.913580716,206,75,51.24378109,11.71875,19,94,9,215
person,yolov8s,11983632613_4efcf5f3d3_z.jpg,402,640,3,1,0.895897746,171,408,42.53731343,63.75,232,640,190,361
person,yolov8s,11983632613_4efcf5f3d3_z.jpg,402,640,3,1,0.830657244,106,33,26.3681592,5.15625,345,378,20,126
person,yolov8s,11983632613_4efcf5f3d3_z.jpg,402,640,3,1,0.821368635,78,46,19.40298507,7.1875,298,344,46,124
person,yolov8s,11983632613_4efcf5f3d3_z.jpg,402,640,3,1,0.813396513,118,31,29.35323383,4.84375,128,159,47,165
person,yolov8s,11983632613_4efcf5f3d3_z.jpg,402,640,3,1,0.79111594,89,37,22.13930348,5.78125,474,511,33,122
person,yolov8s,11983632613_4efcf5f3d3_z.jpg,402,640,3,1,0.759608507,120,36,29.85074627,5.625,80,116,49,169
person,yolov8s,11983632613_4efcf5f3d3_z.jpg,402,640,3,1,0.582224131,82,25,20.39800995,3.90625,259,284,64,146
person,yolov8s,11983632613_4efcf5f3d3_z.jpg,402,640,3,1,0.561217904,122,44,30.34825871,6.875,0,44,50,172
person,yolov8s,11983632613_4efcf5f3d3_z.jpg,402,640,3,1,0.456620783,72,27,17.91044776,4.21875,275,302,59,131
person,yolov8s,11983632613_4efcf5f3d3_z.jpg,402,640,3,1,0.431538254,122,30,30.34825871,4.6875,0,30,50,172
person,yolov8s,11983632613_4efcf5f3d3_z.jpg,402,640,3,1,0.300434053,79,18,19.65174129,2.8125,328,346,43,122
person,yolov8s,15625756039_d59f4e16fa_z.jpg,480,640,3,1,0.941184282,351,155,73.125,24.21875,25,180,129,480
person,yolov8s,15625756039_d59f4e16fa_z.jpg,480,640,3,1,0.920250595,404,173,84.16666667,27.03125,205,378,76,480
person,yolov8s,15625756039_d59f4e16fa_z.jpg,480,640,3,1,0.902091146,353,138,73.54166667,21.5625,424,562,126,479
person,yolov8s,15625756039_d59f4e16fa_z.jpg,480,640,3,1,0.849635363,397,98,82.70833333,15.3125,360,458,82,479
person,yolov8s,6217890759_2a6a04d1d9_z.jpg,427,640,3,1,0.922044516,322,101,75.40983607,15.78125,306,407,58,380
person,yolov8s,6217890759_2a6a04d1d9_z.jpg,427,640,3,1,0.921874404,305,111,71.42857143,17.34375,456,567,94,399
person,yolov8s,6217890759_2a6a04d1d9_z.jpg,427,640,3,1,0.898777843,288,81,67.44730679,12.65625,389,470,94,382
person,yolov8s,6217890759_2a6a04d1d9_z.jpg,427,640,3,1,0.89798981,310,112,72.59953162,17.5,59,171,103,413
person,yolov8s,6217890759_2a6a04d1d9_z.jpg,427,640,3,1,0.893303931,300,84,70.25761124,13.125,234,318,70,370
person,yolov8s,6217890759_2a6a04d1d9_z.jpg,427,640,3,1,0.890843749,281,97,65.80796253,15.15625,151,248,92,373
person,yolov8s,3195432512_d0a96b2967_z.jpg,640,480,3,1,0.912173927,638,471,99.6875,98.125,2,473,0,638
person,yolov8s,16789366715_633121f7bb_z.jpg,640,457,3,1,0.917016745,629,389,98.28125,85.12035011,67,456,2,631
person,yolov8s,3442716929_7a26250063_z.jpg,640,427,3,1,0.899616182,586,422,91.5625,98.82903981,5,427,52,638
person,yolov8s,5943858783_a2cc450fb3_z.jpg,421,639,3,1,0.932521284,381,169,90.49881235,26.44757433,237,406,37,418
person,yolov8s,5943858783_a2cc450fb3_z.jpg,421,639,3,1,0.914286017,385,156,91.44893112,24.41314554,387,543,33,418
person,yolov8s,5943858783_a2cc450fb3_z.jpg,421,639,3,1,0.896575332,364,152,86.4608076,23.78716745,0,152,51,415
person,yolov8s,5943858783_a2cc450fb3_z.jpg,421,639,3,1,0.82125926,322,138,76.48456057,21.59624413,128,266,95,417
person,yolov8s,5425389979_390e3f3881_z.jpg,456,640,3,1,0.890746057,113,101,24.78070175,15.78125,539,640,300,413
person,yolov8s,5425389979_390e3f3881_z.jpg,456,640,3,1,0.867095351,124,105,27.19298246,16.40625,130,235,274,398
person,yolov8s,5425389979_390e3f3881_z.jpg,456,640,3,1,0.865296483,122,96,26.75438596,15,431,527,280,402
person,yolov8s,5425389979_390e3f3881_z.jpg,456,640,3,1,0.845636904,204,100,44.73684211,15.625,12,112,169,373
person,yolov8s,5425389979_390e3f3881_z.jpg,456,640,3,1,0.822010517,108,103,23.68421053,16.09375,330,433,292,400
person,yolov8s,5425389979_390e3f3881_z.jpg,456,640,3,1,0.820508301,173,94,37.93859649,14.6875,98,192,174,347
person,yolov8s,5425389979_390e3f3881_z.jpg,456,640,3,1,0.792042255,208,96,45.61403509,15,511,607,179,387
person,yolov8s,5425389979_390e3f3881_z.jpg,456,640,3,1,0.772550166,170,92,37.28070175,14.375,436,528,169,339
person,yolov8s,5425389979_390e3f3881_z.jpg,456,640,3,1,0.733522177,105,94,23.02631579,14.6875,234,328,293,398
person,yolov8s,5425389979_390e3f3881_z.jpg,456,640,3,1,0.728103995,145,79,31.79824561,12.34375,423,502,89,234
person,yolov8s,5425389979_390e3f3881_z.jpg,456,640,3,1,0.717584789,118,103,25.87719298,16.09375,30,133,292,410
person,yolov8s,5425389979_390e3f3881_z.jpg,456,640,3,1,0.704283535,179,94,39.25438596,14.6875,352,446,179,358
person,yolov8s,5425389979_390e3f3881_z.jpg,456,640,3,1,0.661173701,219,82,48.02631579,12.8125,189,271,161,380
person,yolov8s,5425389979_390e3f3881_z.jpg,456,640,3,1,0.596225798,143,68,31.35964912,10.625,500,568,101,244
person,yolov8s,5425389979_390e3f3881_z.jpg,456,640,3,1,0.51312685,143,72,31.35964912,11.25,354,426,92,235
person,yolov8s,5425389979_390e3f3881_z.jpg,456,640,3,1,0.46567747,124,77,27.19298246,12.03125,204,281,105,229
person,yolov8s,5425389979_390e3f3881_z.jpg,456,640,3,1,0.448016554,198,95,43.42105263,14.84375,266,361,158,356
person,yolov8s,5425389979_390e3f3881_z.jpg,456,640,3,1,0.411361307,136,66,29.8245614,10.3125,143,209,102,238
person,yolov8s,5425389979_390e3f3881_z.jpg,456,640,3,1,0.404679984,136,68,29.8245614,10.625,76,144,102,238
person,yolov8s,5425389979_390e3f3881_z.jpg,456,640,3,1,0.344568998,140,83,30.70175439,12.96875,278,361,88,228
person,yolov8s,5425389979_390e3f3881_z.jpg,456,640,3,1,0.326432049,101,45,22.14912281,7.03125,479,524,55,156
person,yolov8s,5425389979_390e3f3881_z.jpg,456,640,3,1,0.290341824,129,73,28.28947368,11.40625,111,184,35,164
person,yolov8s,5387089136_efcdc42456_z.jpg,431,640,3,1,0.925609887,342,94,79.35034803,14.6875,0,94,49,391
person,yolov8s,5387089136_efcdc42456_z.jpg,431,640,3,1,0.92466408,369,98,85.61484919,15.3125,542,640,55,424
person,yolov8s,5387089136_efcdc42456_z.jpg,431,640,3,1,0.913554668,264,101,61.25290023,15.78125,82,183,164,428
person,yolov8s,5387089136_efcdc42456_z.jpg,431,640,3,1,0.910409808,244,97,56.612529,15.15625,495,592,186,430
person,yolov8s,5387089136_efcdc42456_z.jpg,431,640,3,1,0.90557009,228,97,52.90023202,15.15625,240,337,198,426
person,yolov8s,5387089136_efcdc42456_z.jpg,431,640,3,1,0.900414944,231,101,53.5962877,15.78125,401,502,197,428
person,yolov8s,5387089136_efcdc42456_z.jpg,431,640,3,1,0.883406222,231,92,53.5962877,14.375,164,256,194,425
person,yolov8s,5387089136_efcdc42456_z.jpg,431,640,3,1,0.873570383,244,87,56.612529,13.59375,332,419,187,431
person,yolov8s,5387089136_efcdc42456_z.jpg,431,640,3,1,0.870360255,86,79,19.95359629,12.34375,297,376,7,93
person,yolov8s,5387089136_efcdc42456_z.jpg,431,640,3,1,0.845288396,177,80,41.06728538,12.5,78,158,68,245
person,yolov8s,5387089136_efcdc42456_z.jpg,431,640,3,1,0.833246648,147,71,34.10672854,11.09375,516,587,43,190
person,yolov8s,5387089136_efcdc42456_z.jpg,431,640,3,1,0.814931393,78,54,18.0974478,8.4375,481,535,29,107
person,yolov8s,5387089136_efcdc42456_z.jpg,431,640,3,1,0.805274248,58,87,13.45707657,13.59375,360,447,37,95
person,yolov8s,5387089136_efcdc42456_z.jpg,431,640,3,1,0.715736032,64,36,14.84918794,5.625,50,86,69,133
person,yolov8s,5387089136_efcdc42456_z.jpg,431,640,3,1,0.449596137,64,99,14.84918794,15.46875,230,329,29,93
person,yolov8s,5387089136_efcdc42456_z.jpg,431,640,3,1,0.327453703,63,69,14.61716937,10.78125,230,299,29,92
person,yolov8s,5387089136_efcdc42456_z.jpg,431,640,3,1,0.266588598,71,61,16.47331787,9.53125,131,192,27,98
person,yolov8s,3300269400_c276d7a1a7_z.jpg,469,639,3,1,0.943941414,452,601,96.37526652,94.05320814,31,632,10,462
person,yolov8s,528252616_a57e6257ff_z.jpg,480,640,3,1,0.926575959,329,167,68.54166667,26.09375,0,167,150,479
person,yolov8s,528252616_a57e6257ff_z.jpg,480,640,3,1,0.902342021,355,223,73.95833333,34.84375,417,640,124,479
person,yolov8s,528252616_a57e6257ff_z.jpg,480,640,3,1,0.733745217,455,378,94.79166667,59.0625,209,587,24,479
person,yolov8s,6723753569_a1d8678cde_z.jpg,640,425,3,1,0.928745866,612,423,95.625,99.52941176,0,423,27,639
person,yolov8s,201365540_d1af73d7cd_z.jpg,640,482,3,1,0.883499324,622,476,97.1875,98.75518672,6,482,16,638
person,yolov8s,15091650494_d8a5f37637_z.jpg,640,427,3,1,0.96043098,578,425,90.3125,99.53161593,1,426,61,639
person,yolov8s,2365652301_0de626bd97_z.jpg,498,640,3,1,0.925481617,352,123,70.68273092,19.21875,391,514,71,423
person,yolov8s,2365652301_0de626bd97_z.jpg,498,640,3,1,0.866361737,309,142,62.04819277,22.1875,226,368,115,424
person,yolov8s,8960442702_6c931904f0_z.jpg,427,640,3,1,0.914899945,419,184,98.1264637,28.75,82,266,5,424
person,yolov8s,8960442702_6c931904f0_z.jpg,427,640,3,1,0.896968663,423,230,99.06323185,35.9375,266,496,0,423
person,yolov8s,5594762666_e157f338f0_z.jpg,425,640,3,1,0.947713912,402,295,94.58823529,46.09375,345,640,18,420
person,yolov8s,5594762666_e157f338f0_z.jpg,425,640,3,1,0.908466697,369,284,86.82352941,44.375,1,285,52,421
person,yolov8s,7192116992_5447de0caa_z.jpg,640,480,3,1,0.949433744,610,479,95.3125,99.79166667,0,479,28,638
person,yolov8s,8562326627_1a68052e58_z.jpg,640,582,3,1,0.862703085,636,582,99.375,100,0,582,2,638
person,yolov8s,4380790081_1cbcb573ec_z.jpg,421,640,3,1,0.903079987,380,574,90.26128266,89.6875,46,620,38,418
person,yolov8s,15392489891_905432249f_z.jpg,427,640,3,1,0.940558314,292,190,68.38407494,29.6875,63,253,1,293
person,yolov8s,15392489891_905432249f_z.jpg,427,640,3,1,0.896090686,261,229,61.12412178,35.78125,124,353,160,421
person,yolov8s,15392489891_905432249f_z.jpg,427,640,3,1,0.873329282,245,185,57.37704918,28.90625,338,523,179,424
person,yolov8s,15392489891_905432249f_z.jpg,427,640,3,1,0.72197026,103,81,24.12177986,12.65625,349,430,147,250
person,yolov8s,15392489891_905432249f_z.jpg,427,640,3,1,0.487633288,57,47,13.34894614,7.34375,241,288,132,189
person,yolov8s,4479906928_4ab0604d1c_z.jpg,640,480,3,1,0.805149198,637,351,99.53125,73.125,38,389,1,638
person,yolov8s,2392419690_8495e2b2c9_z.jpg,496,640,3,1,0.934170067,242,200,48.79032258,31.25,324,524,1,243
person,yolov8s,2392419690_8495e2b2c9_z.jpg,496,640,3,1,0.925971091,241,257,48.58870968,40.15625,3,260,3,244
person,yolov8s,2392419690_8495e2b2c9_z.jpg,496,640,3,1,0.900823951,240,195,48.38709677,30.46875,3,198,251,491
person,yolov8s,2392419690_8495e2b2c9_z.jpg,496,640,3,1,0.896840453,239,159,48.18548387,24.84375,323,482,250,489
person,yolov8s,2392419690_8495e2b2c9_z.jpg,496,640,3,1,0.894526839,174,217,35.08064516,33.90625,420,637,318,492
person,yolov8s,2392419690_8495e2b2c9_z.jpg,496,640,3,1,0.842549205,77,59,15.52419355,9.21875,16,75,251,328
person,yolov8s,2392419690_8495e2b2c9_z.jpg,496,640,3,1,0.457066029,116,178,23.38709677,27.8125,421,599,129,245
person,yolov8s,2392419690_8495e2b2c9_z.jpg,496,640,3,1,0.432529569,118,138,23.79032258,21.5625,102,240,374,492
person,yolov8s,8538565946_199e28b584_z.jpg,612,612,3,1,0.861564934,596,527,97.38562092,86.11111111,54,581,13,609
person,yolov8s,15083791924_c7195faca3_z.jpg,428,640,3,1,0.920906961,424,405,99.06542056,63.28125,49,454,0,424
person,yolov8s,8922688952_9cacbffe29_z.jpg,639,402,3,1,0.684328079,636,275,99.53051643,68.4079602,0,275,0,636
person,yolov8s,8922688952_9cacbffe29_z.jpg,639,402,3,1,0.656348228,633,214,99.06103286,53.23383085,187,401,3,636
person,yolov8s,5540859766_5596c9c59e_z.jpg,520,600,3,1,0.904119015,480,573,92.30769231,95.5,3,576,35,515
person,yolov8s,5826499075_8c91ec270b_z.jpg,640,478,3,0,0,0,0,0,0,0,0,0,0
person,yolov8s,4728907141_f9e5aa4bce_z.jpg,480,640,3,1,0.932375669,324,205,67.5,32.03125,186,391,58,382
person,yolov8s,4728907141_f9e5aa4bce_z.jpg,480,640,3,1,0.918110549,181,120,37.70833333,18.75,0,120,23,204
person,yolov8s,4728907141_f9e5aa4bce_z.jpg,480,640,3,1,0.859744966,178,96,37.08333333,15,492,588,17,195
person,yolov8s,4728907141_f9e5aa4bce_z.jpg,480,640,3,1,0.255039036,47,22,9.791666667,3.4375,0,22,25,72
person,yolov8s,5316877862_ccdebd50e5_z.jpg,419,639,3,1,0.928344071,381,245,90.93078759,38.34115806,12,257,34,415
person,yolov8s,5316877862_ccdebd50e5_z.jpg,419,639,3,1,0.918268204,366,357,87.35083532,55.8685446,282,639,49,415
person,yolov8s,5316877862_ccdebd50e5_z.jpg,419,639,3,1,0.807481349,409,91,97.61336516,14.24100156,0,91,1,410
person,yolov8s,5316877862_ccdebd50e5_z.jpg,419,639,3,1,0.647587776,57,52,13.60381862,8.13771518,298,350,362,419
person,yolov8s,5316877862_ccdebd50e5_z.jpg,419,639,3,1,0.495571733,216,35,51.55131265,5.477308294,242,277,201,417
person,yolov8s,5316877862_ccdebd50e5_z.jpg,419,639,3,1,0.369078875,69,23,16.46778043,3.599374022,77,100,38,107
person,yolov8s,5316877862_ccdebd50e5_z.jpg,419,639,3,1,0.319349766,181,17,43.19809069,2.660406886,260,277,193,374
person,yolov8s,5316877862_ccdebd50e5_z.jpg,419,639,3,1,0.276825368,39,27,9.307875895,4.225352113,278,305,380,419
person,yolov8s,15543230406_71c5a59208_z.jpg,463,640,3,1,0.865236938,365,244,78.8336933,38.125,227,471,92,457
person,yolov8s,15543230406_71c5a59208_z.jpg,463,640,3,1,0.849229217,439,211,94.81641469,32.96875,0,211,18,457
person,yolov8s,15543230406_71c5a59208_z.jpg,463,640,3,1,0.768297613,367,408,79.26565875,63.75,228,636,92,459
person,yolov8s,15543230406_71c5a59208_z.jpg,463,640,3,1,0.322084844,278,147,60.04319654,22.96875,307,454,180,458
person,yolov8s,6431185703_6c72dd7b5e_z.jpg,427,640,3,1,0.715765238,115,49,26.93208431,7.65625,491,540,203,318
person,yolov8s,6431185703_6c72dd7b5e_z.jpg,427,640,3,1,0.684366584,136,49,31.8501171,7.65625,211,260,184,320
person,yolov8s,6431185703_6c72dd7b5e_z.jpg,427,640,3,1,0.677042723,119,69,27.86885246,10.78125,551,620,183,302
person,yolov8s,6431185703_6c72dd7b5e_z.jpg,427,640,3,1,0.596901119,140,71,32.78688525,11.09375,424,495,200,340
person,yolov8s,6431185703_6c72dd7b5e_z.jpg,427,640,3,1,0.570010006,95,34,22.24824356,5.3125,88,122,195,290
person,yolov8s,6431185703_6c72dd7b5e_z.jpg,427,640,3,1,0.562560618,169,63,39.57845433,9.84375,353,416,186,355
person,yolov8s,6431185703_6c72dd7b5e_z.jpg,427,640,3,1,0.560893953,102,36,23.88758782,5.625,180,216,186,288
person,yolov8s,6431185703_6c72dd7b5e_z.jpg,427,640,3,1,0.548015058,107,37,25.05854801,5.78125,119,156,194,301
person,yolov8s,6431185703_6c72dd7b5e_z.jpg,427,640,3,1,0.54317975,117,58,27.40046838,9.0625,468,526,172,289
person,yolov8s,6431185703_6c72dd7b5e_z.jpg,427,640,3,1,0.502981067,155,54,36.29976581,8.4375,294,348,185,340
person,yolov8s,6431185703_6c72dd7b5e_z.jpg,427,640,3,1,0.414927185,90,33,21.07728337,5.15625,159,192,216,306
person,yolov8s,6431185703_6c72dd7b5e_z.jpg,427,640,3,1,0.39086169,73,24,17.09601874,3.75,44,68,208,281
person,yolov8s,6431185703_6c72dd7b5e_z.jpg,427,640,3,1,0.316924453,82,28,19.20374707,4.375,62,90,203,285
person,yolov8s,6431185703_6c72dd7b5e_z.jpg,427,640,3,1,0.273360908,91,30,21.31147541,4.6875,252,282,189,280
person,yolov8x,6499183869_45bb8908c3_z.jpg,640,427,3,1,0.969943285,583,426,91.09375,99.76580796,0,426,55,638
person,yolov8x,3409776362_07a8bb7f17_z.jpg,523,640,3,1,0.91167146,486,425,92.92543021,66.40625,87,512,30,516
person,yolov8x,8399932836_19c21d3779_z.jpg,640,524,3,1,0.970034242,573,420,89.53125,80.15267176,97,517,58,631
person,yolov8x,8349516772_6928ba8b88_z.jpg,480,640,3,1,0.966897666,433,507,90.20833333,79.21875,2,509,39,472
person,yolov8x,738798561_2d54b53ec5_z.jpg,640,480,3,1,0.956456244,580,427,90.625,88.95833333,33,460,58,638
person,yolov8x,4282546783_10b5e0a62e_z.jpg,480,640,3,1,0.959248185,479,184,99.79166667,28.75,0,184,0,479
person,yolov8x,4282546783_10b5e0a62e_z.jpg,480,640,3,1,0.907794535,395,146,82.29166667,22.8125,214,360,85,480
person,yolov8x,4282546783_10b5e0a62e_z.jpg,480,640,3,1,0.851844788,194,110,40.41666667,17.1875,137,247,261,455
person,yolov8x,4282546783_10b5e0a62e_z.jpg,480,640,3,1,0.831866801,267,89,55.625,13.90625,389,478,162,429
person,yolov8x,4282546783_10b5e0a62e_z.jpg,480,640,3,1,0.796067476,324,82,67.5,12.8125,310,392,146,470
person,yolov8x,4282546783_10b5e0a62e_z.jpg,480,640,3,1,0.790602744,215,58,44.79166667,9.0625,449,507,189,404
person,yolov8x,4282546783_10b5e0a62e_z.jpg,480,640,3,1,0.771568298,313,67,65.20833333,10.46875,337,404,131,444
person,yolov8x,4282546783_10b5e0a62e_z.jpg,480,640,3,1,0.770953953,139,41,28.95833333,6.40625,514,555,242,381
person,yolov8x,4282546783_10b5e0a62e_z.jpg,480,640,3,1,0.694271863,112,44,23.33333333,6.875,573,617,254,366
person,yolov8x,4282546783_10b5e0a62e_z.jpg,480,640,3,1,0.624955118,129,29,26.875,4.53125,537,566,239,368
person,yolov8x,4282546783_10b5e0a62e_z.jpg,480,640,3,1,0.600636721,163,35,33.95833333,5.46875,489,524,220,383
person,yolov8x,4282546783_10b5e0a62e_z.jpg,480,640,3,1,0.475403816,97,21,20.20833333,3.28125,607,628,258,355
person,yolov8x,4282546783_10b5e0a62e_z.jpg,480,640,3,1,0.452147782,79,19,16.45833333,2.96875,621,640,275,354
person,yolov8x,4282546783_10b5e0a62e_z.jpg,480,640,3,1,0.318180174,31,28,6.458333333,4.375,301,329,127,158
person,yolov8x,7166182137_a5679c9fa4_z.jpg,640,427,3,1,0.971158087,547,340,85.46875,79.62529274,13,353,92,639
person,yolov8x,4386974407_c2915fa9b1_z.jpg,639,457,3,1,0.950893044,416,174,65.10172144,38.07439825,141,315,96,512
person,yolov8x,6881088206_947a7622d4_z.jpg,640,480,3,1,0.943905473,469,282,73.28125,58.75,139,421,92,561
person,yolov8x,6881088206_947a7622d4_z.jpg,640,480,3,1,0.912874877,323,130,50.46875,27.08333333,1,131,316,639
person,yolov8x,8874948232_195679aa4e_z.jpg,427,640,3,1,0.943037152,322,202,75.40983607,31.5625,0,202,99,421
person,yolov8x,8874948232_195679aa4e_z.jpg,427,640,3,1,0.942324221,413,239,96.72131148,37.34375,288,527,9,422
person,yolov8x,8874948232_195679aa4e_z.jpg,427,640,3,1,0.912123442,172,233,40.28103044,36.40625,179,412,252,424
person,yolov8x,8874948232_195679aa4e_z.jpg,427,640,3,1,0.899491787,203,178,47.54098361,27.8125,462,640,1,204
person,yolov8x,8874948232_195679aa4e_z.jpg,427,640,3,1,0.864979088,135,88,31.61592506,13.75,552,640,161,296
person,yolov8x,8874948232_195679aa4e_z.jpg,427,640,3,1,0.844678879,140,201,32.78688525,31.40625,439,640,282,422
person,yolov8x,8874948232_195679aa4e_z.jpg,427,640,3,1,0.841428995,233,103,54.56674473,16.09375,467,570,115,348
person,yolov8x,8874948232_195679aa4e_z.jpg,427,640,3,1,0.587039173,160,40,37.470726,6.25,600,640,7,167
person,yolov8x,8874948232_195679aa4e_z.jpg,427,640,3,1,0.34658581,234,207,54.80093677,32.34375,104,311,74,308
person,yolov8x,8874948232_195679aa4e_z.jpg,427,640,3,1,0.342050254,237,310,55.50351288,48.4375,1,311,73,310
person,yolov8x,202416281_527efb7418_z.jpg,639,469,3,1,0.936307967,466,215,72.92644757,45.84221748,169,384,129,595
person,yolov8x,5605719660_5bed05cca3_z.jpg,425,640,3,1,0.962219238,418,404,98.35294118,63.125,236,640,1,419
person,yolov8x,5605719660_5bed05cca3_z.jpg,425,640,3,1,0.948018193,406,249,95.52941176,38.90625,0,249,13,419
person,yolov8x,16850385890_8105762655_z.jpg,640,425,3,1,0.917616606,579,413,90.46875,97.17647059,11,424,59,638
person,yolov8x,16850385890_8105762655_z.jpg,640,425,3,1,0.760001063,429,125,67.03125,29.41176471,0,125,210,639
person,yolov8x,98052295_1221189a77_z.jpg,534,640,3,1,0.858049452,526,636,98.50187266,99.375,2,638,2,528
person,yolov8x,4030862073_d697f506b0_z.jpg,601,640,3,1,0.964847744,541,344,90.01663894,53.75,3,347,51,592
person,yolov8x,4030862073_d697f506b0_z.jpg,601,640,3,1,0.949029863,565,356,94.00998336,55.625,283,639,28,593
person,yolov8x,2768961204_712996d2bd_z.jpg,639,355,3,1,0.952274621,497,216,77.77777778,60.84507042,101,317,116,613
person,yolov8x,15983066535_629c335c63_z.jpg,427,640,3,1,0.97174418,402,462,94.14519906,72.1875,111,573,20,422
person,yolov8x,2946145533_75f5268f19_z.jpg,480,640,3,1,0.593947709,477,609,99.375,95.15625,2,611,1,478
person,yolov8x,8744937858_81c17befae_z.jpg,640,426,3,1,0.932435274,487,306,76.09375,71.83098592,59,365,62,549
person,yolov8x,8744937858_81c17befae_z.jpg,640,426,3,1,0.361103535,197,73,30.78125,17.13615023,353,426,46,243
person,yolov8x,8183126241_e78c7f86ba_z.jpg,425,640,3,1,0.966312349,414,324,97.41176471,50.625,6,330,6,420
person,yolov8x,8183126241_e78c7f86ba_z.jpg,425,640,3,1,0.951849878,378,291,88.94117647,45.46875,289,580,42,420
person,yolov8x,8183126241_e78c7f86ba_z.jpg,425,640,3,1,0.840980053,199,66,46.82352941,10.3125,546,612,223,422
person,yolov8x,8183126241_e78c7f86ba_z.jpg,425,640,3,1,0.464183092,134,31,31.52941176,4.84375,0,31,287,421
person,yolov8x,16954781749_4c32123444_z.jpg,427,640,3,1,0.938639522,336,212,78.68852459,33.125,138,350,86,422
person,yolov8x,16954781749_4c32123444_z.jpg,427,640,3,1,0.932512879,329,202,77.04918033,31.5625,334,536,93,422
person,yolov8x,7581740758_a1c5cf246e_z.jpg,640,427,3,1,0.971682072,550,410,85.9375,96.01873536,0,410,88,638
person,yolov8x,5298850167_d1e13e9551_z.jpg,391,640,3,1,0.952682674,328,300,83.88746803,46.875,1,301,56,384
person,yolov8x,5298850167_d1e13e9551_z.jpg,391,640,3,1,0.934743643,355,322,90.79283887,50.3125,318,640,29,384
person,yolov8x,5298850167_d1e13e9551_z.jpg,391,640,3,1,0.892462254,320,337,81.84143223,52.65625,141,478,66,386
person,yolov8x,5298850167_d1e13e9551_z.jpg,391,640,3,1,0.875068605,259,137,66.24040921,21.40625,0,137,51,310
person,yolov8x,4901520304_aa5c10705e_z.jpg,480,640,3,1,0.963088751,480,608,100,95,1,609,0,480
person,yolov8x,4901520304_aa5c10705e_z.jpg,480,640,3,1,0.459965795,308,77,64.16666667,12.03125,0,77,166,474
person,yolov8x,4901520304_aa5c10705e_z.jpg,480,640,3,1,0.441756517,67,75,13.95833333,11.71875,0,75,166,233
person,yolov8x,14507981482_c50d893620_z.jpg,640,503,3,1,0.935225725,530,185,82.8125,36.77932406,175,360,106,636
person,yolov8x,14507981482_c50d893620_z.jpg,640,503,3,1,0.927524209,462,140,72.1875,27.83300199,37,177,107,569
person,yolov8x,14507981482_c50d893620_z.jpg,640,503,3,1,0.875335336,446,126,69.6875,25.04970179,134,260,66,512
person,yolov8x,14507981482_c50d893620_z.jpg,640,503,3,1,0.851730525,402,85,62.8125,16.89860835,403,488,52,454
person,yolov8x,14507981482_c50d893620_z.jpg,640,503,3,1,0.750385523,122,51,19.0625,10.13916501,318,369,69,191
person,yolov8x,14507981482_c50d893620_z.jpg,640,503,3,1,0.700417101,469,162,73.28125,32.20675944,306,468,94,563
person,yolov8x,14507981482_c50d893620_z.jpg,640,503,3,1,0.65020591,281,98,43.90625,19.48310139,353,451,338,619
person,yolov8x,14507981482_c50d893620_z.jpg,640,503,3,1,0.554425299,112,52,17.5,10.33797217,116,168,59,171
person,yolov8x,7742706992_27215ef7f8_z.jpg,640,428,3,1,0.948544085,528,325,82.5,75.93457944,82,407,111,639
person,yolov8x,7742706992_27215ef7f8_z.jpg,640,428,3,1,0.91944772,341,182,53.28125,42.52336449,233,415,43,384
person,yolov8x,7742706992_27215ef7f8_z.jpg,640,428,3,1,0.767233551,172,30,26.875,7.009345794,397,427,166,338
person,yolov8x,7742706992_27215ef7f8_z.jpg,640,428,3,1,0.684466958,131,90,20.46875,21.02803738,0,90,509,640
person,yolov8x,11132512636_ebb3a6a070_z.jpg,427,640,3,1,0.834845364,238,74,55.73770492,11.5625,321,395,146,384
person,yolov8x,11132512636_ebb3a6a070_z.jpg,427,640,3,1,0.712502241,300,126,70.25761124,19.6875,202,328,93,393
person,yolov8x,11132512636_ebb3a6a070_z.jpg,427,640,3,1,0.706043661,256,122,59.95316159,19.0625,60,182,124,380
person,yolov8x,11132512636_ebb3a6a070_z.jpg,427,640,3,1,0.686955214,365,171,85.48009368,26.71875,392,563,47,412
person,yolov8x,11132512636_ebb3a6a070_z.jpg,427,640,3,1,0.576187372,203,52,47.54098361,8.125,166,218,169,372
person,yolov8x,7843905188_07e5d2a569_z.jpg,425,640,3,1,0.938768566,344,347,80.94117647,54.21875,0,347,75,419
person,yolov8x,7843905188_07e5d2a569_z.jpg,425,640,3,1,0.918362617,400,327,94.11764706,51.09375,312,639,19,419
person,yolov8x,189076128_ee6f694a30_z.jpg,640,428,3,1,0.946149826,571,418,89.21875,97.6635514,1,419,67,638
person,yolov8x,189076128_ee6f694a30_z.jpg,640,428,3,1,0.475410134,130,68,20.3125,15.88785047,360,428,509,639
person,yolov8x,6098643678_fc8044b5ac_z.jpg,427,640,3,1,0.96104908,367,258,85.94847775,40.3125,381,639,55,422
person,yolov8x,6098643678_fc8044b5ac_z.jpg,427,640,3,1,0.887775183,280,226,65.57377049,35.3125,243,469,143,423
person,yolov8x,6098643678_fc8044b5ac_z.jpg,427,640,3,1,0.83679378,319,266,74.70725995,41.5625,0,266,103,422
person,yolov8x,2534669669_0c1d10c3e6_z.jpg,480,640,3,1,0.914124191,478,531,99.58333333,82.96875,1,532,1,479
person,yolov8x,5210291488_fe9939bdf1_z.jpg,360,640,3,1,0.906628549,172,59,47.77777778,9.21875,206,265,116,288
person,yolov8x,5210291488_fe9939bdf1_z.jpg,360,640,3,1,0.906373382,167,59,46.38888889,9.21875,262,321,125,292
person,yolov8x,5210291488_fe9939bdf1_z.jpg,360,640,3,1,0.903608322,105,53,29.16666667,8.28125,517,570,152,257
person,yolov8x,5210291488_fe9939bdf1_z.jpg,360,640,3,1,0.903484643,178,63,49.44444444,9.84375,150,213,111,289
person,yolov8x,5210291488_fe9939bdf1_z.jpg,360,640,3,1,0.899573565,165,76,45.83333333,11.875,437,513,134,299
person,yolov8x,5210291488_fe9939bdf1_z.jpg,360,640,3,1,0.897785246,180,63,50,9.84375,318,381,115,295
person,yolov8x,5210291488_fe9939bdf1_z.jpg,360,640,3,1,0.888146996,163,61,45.27777778,9.53125,371,432,133,296
person,yolov8x,5210291488_fe9939bdf1_z.jpg,360,640,3,1,0.876848757,153,51,42.5,7.96875,94,145,133,286
person,yolov8x,5210291488_fe9939bdf1_z.jpg,360,640,3,1,0.871799231,159,54,44.16666667,8.4375,39,93,122,281
person,yolov8x,5210291488_fe9939bdf1_z.jpg,360,640,3,1,0.728441179,154,45,42.77777778,7.03125,77,122,112,266
person,yolov8x,5210291488_fe9939bdf1_z.jpg,360,640,3,1,0.586119235,55,35,15.27777778,5.46875,260,295,105,160
person,yolov8x,5210291488_fe9939bdf1_z.jpg,360,640,3,1,0.576475859,98,63,27.22222222,9.84375,577,640,161,259
person,yolov8x,5210291488_fe9939bdf1_z.jpg,360,640,3,1,0.46422407,104,127,28.88888889,19.84375,480,607,235,339
person,yolov8x,5210291488_fe9939bdf1_z.jpg,360,640,3,1,0.409453481,117,90,32.5,14.0625,550,640,241,358
person,yolov8x,4083309359_020d325f73_z.jpg,640,427,3,1,0.972462595,614,425,95.9375,99.53161593,0,425,24,638
person,yolov8x,8031274301_1d9bc9b665_z.jpg,640,427,3,1,0.960122645,566,353,88.4375,82.66978923,0,353,72,638
person,yolov8x,8031274301_1d9bc9b665_z.jpg,640,427,3,1,0.927464843,638,183,99.6875,42.85714286,243,426,0,638
person,yolov8x,5481347426_620620145e_z.jpg,427,640,3,1,0.956950724,388,163,90.86651054,25.46875,0,163,34,422
person,yolov8x,5481347426_620620145e_z.jpg,427,640,3,1,0.929882824,382,225,89.46135831,35.15625,202,427,39,421
person,yolov8x,5481347426_620620145e_z.jpg,427,640,3,1,0.928582668,238,106,55.73770492,16.5625,514,620,186,424
person,yolov8x,5481347426_620620145e_z.jpg,427,640,3,1,0.892615736,250,83,58.54800937,12.96875,456,539,175,425
person,yolov8x,5481347426_620620145e_z.jpg,427,640,3,1,0.828482211,303,90,70.96018735,14.0625,198,288,120,423
person,yolov8x,5481347426_620620145e_z.jpg,427,640,3,1,0.691901624,272,62,63.70023419,9.6875,116,178,155,427
person,yolov8x,5481347426_620620145e_z.jpg,427,640,3,1,0.541513264,131,21,30.67915691,3.28125,619,640,216,347
person,yolov8x,5481347426_620620145e_z.jpg,427,640,3,1,0.436563611,141,61,33.02107728,9.53125,391,452,236,377
person,yolov8x,5481347426_620620145e_z.jpg,427,640,3,1,0.404820502,47,41,11.00702576,6.40625,259,300,84,131
person,yolov8x,5481347426_620620145e_z.jpg,427,640,3,1,0.278745741,131,41,30.67915691,6.40625,172,213,222,353
person,yolov8x,5481347426_620620145e_z.jpg,427,640,3,1,0.267440498,112,85,26.2295082,13.28125,202,287,121,233
person,yolov8x,5513074265_5b31a2339b_z.jpg,428,639,3,1,0.945587695,423,499,98.8317757,78.09076682,0,499,0,423
person,yolov8x,5513074265_5b31a2339b_z.jpg,428,639,3,1,0.766777456,422,285,98.59813084,44.60093897,0,285,2,424
person,yolov8x,10921149963_027e750820_z.jpg,425,640,3,1,0.934107542,328,209,77.17647059,32.65625,431,640,87,415
person,yolov8x,10921149963_027e750820_z.jpg,425,640,3,1,0.749551296,340,234,80,36.5625,0,234,74,414
person,yolov8x,10921149963_027e750820_z.jpg,425,640,3,1,0.732011855,208,221,48.94117647,34.53125,199,420,125,333
person,yolov8x,268134569_0cea602ccb_z.jpg,480,640,3,1,0.937501132,455,376,94.79166667,58.75,263,639,24,479
person,yolov8x,268134569_0cea602ccb_z.jpg,480,640,3,1,0.919437051,284,327,59.16666667,51.09375,1,328,195,479
person,yolov8x,268134569_0cea602ccb_z.jpg,480,640,3,1,0.858532548,479,313,99.79166667,48.90625,54,367,0,479
person,yolov8x,268134569_0cea602ccb_z.jpg,480,640,3,1,0.823895216,326,320,67.91666667,50,320,640,0,326
person,yolov8x,7163490183_0dff14b5d6_z.jpg,360,640,3,1,0.91152513,349,272,96.94444444,42.5,38,310,6,355
person,yolov8x,8488918795_f8ba7dabb6_z.jpg,594,471,3,1,0.940689802,493,145,82.996633,30.78556263,9,154,91,584
person,yolov8x,8488918795_f8ba7dabb6_z.jpg,594,471,3,1,0.934609056,469,131,78.95622896,27.81316348,301,432,95,564
person,yolov8x,8488918795_f8ba7dabb6_z.jpg,594,471,3,1,0.934424281,488,145,82.15488215,30.78556263,155,300,83,571
person,yolov8x,1444579876_8c02edf580_z.jpg,639,483,3,1,0.977026165,595,463,93.114241,95.85921325,1,464,34,629
person,yolov8x,6111783458_61cc1f0f88_z.jpg,640,425,3,1,0.962070167,620,424,96.875,99.76470588,0,424,18,638
person,yolov8x,10915137264_e8c23d54b4_z.jpg,639,428,3,1,0.955940783,490,319,76.68231612,74.53271028,44,363,149,639
person,yolov8x,4029738064_00c4cd038b_z.jpg,425,640,3,1,0.948724329,346,274,81.41176471,42.8125,48,322,73,419
person,yolov8x,6309741882_b074ee1a96_z.jpg,541,640,3,1,0.918850124,530,400,97.96672828,62.5,237,637,2,532
person,yolov8x,6309741882_b074ee1a96_z.jpg,541,640,3,1,0.647136211,315,299,58.22550832,46.71875,1,300,219,534
person,yolov8x,6309741882_b074ee1a96_z.jpg,541,640,3,1,0.298483074,245,189,45.28650647,29.53125,0,189,290,535
person,yolov8x,8572756223_94130c5e61_z.jpg,481,640,3,1,0.964145303,467,346,97.08939709,54.0625,0,346,7,474
person,yolov8x,8572756223_94130c5e61_z.jpg,481,640,3,1,0.95707804,455,334,94.59459459,52.1875,304,638,19,474
person,yolov8x,16658372825_affc436763_z.jpg,640,369,3,1,0.912149429,406,171,63.4375,46.34146341,93,264,122,528
person,yolov8x,5298849761_aeeed1a3f9_z.jpg,640,425,3,1,0.940621972,623,424,97.34375,99.76470588,0,424,14,637
person,yolov8x,16433605163_8c9393beb1_z.jpg,480,640,3,1,0.923488855,234,154,48.75,24.0625,102,256,160,394
person,yolov8x,16433605163_8c9393beb1_z.jpg,480,640,3,1,0.896787345,162,178,33.75,27.8125,425,603,318,480
person,yolov8x,16433605163_8c9393beb1_z.jpg,480,640,3,1,0.821115851,175,71,36.45833333,11.09375,39,110,151,326
person,yolov8x,16433605163_8c9393beb1_z.jpg,480,640,3,1,0.795693874,217,70,45.20833333,10.9375,324,394,160,377
person,yolov8x,16433605163_8c9393beb1_z.jpg,480,640,3,1,0.710715055,262,93,54.58333333,14.53125,441,534,156,418
person,yolov8x,16433605163_8c9393beb1_z.jpg,480,640,3,1,0.69471544,225,59,46.875,9.21875,411,470,163,388
person,yolov8x,16433605163_8c9393beb1_z.jpg,480,640,3,1,0.636908054,135,44,28.125,6.875,280,324,161,296
person,yolov8x,16433605163_8c9393beb1_z.jpg,480,640,3,1,0.578658044,297,95,61.875,14.84375,545,640,153,450
person,yolov8x,16433605163_8c9393beb1_z.jpg,480,640,3,1,0.36024192,154,47,32.08333333,7.34375,198,245,170,324
person,yolov8x,16433605163_8c9393beb1_z.jpg,480,640,3,1,0.291898519,325,134,67.70833333,20.9375,506,640,153,478
person,yolov8x,16433605163_8c9393beb1_z.jpg,480,640,3,1,0.260624856,44,17,9.166666667,2.65625,0,17,165,209
person,yolov8x,15071673457_0703cea442_z.jpg,426,640,3,1,0.965278745,373,406,87.55868545,63.4375,100,506,48,421
person,yolov8x,300422857_eb3a885357_z.jpg,640,632,3,1,0.944754004,628,632,98.125,100,0,632,8,636
person,yolov8x,2522213440_edbcb5ba05_z.jpg,428,639,3,1,0.961863875,383,290,89.48598131,45.38341158,247,537,39,422
person,yolov8x,2522213440_edbcb5ba05_z.jpg,428,639,3,1,0.839757681,93,235,21.72897196,36.77621283,404,639,332,425
person,yolov8x,2522213440_edbcb5ba05_z.jpg,428,639,3,1,0.79916352,195,82,45.56074766,12.83255086,2,84,38,233
person,yolov8x,2522213440_edbcb5ba05_z.jpg,428,639,3,1,0.693593919,322,157,75.23364486,24.56964006,482,639,73,395
person,yolov8x,2522213440_edbcb5ba05_z.jpg,428,639,3,1,0.289375067,225,157,52.57009346,24.56964006,482,639,167,392
person,yolov8x,6985531639_71621c1e69_z.jpg,427,640,3,1,0.958780885,420,587,98.36065574,91.71875,44,631,1,421
person,yolov8x,892497288_b916ec820e_z.jpg,481,640,3,1,0.935964704,352,312,73.18087318,48.75,1,313,1,353
person,yolov8x,892497288_b916ec820e_z.jpg,481,640,3,1,0.854677379,390,412,81.08108108,64.375,194,606,76,466
person,yolov8x,892497288_b916ec820e_z.jpg,481,640,3,1,0.714352846,63,54,13.0977131,8.4375,0,54,21,84
person,yolov8x,892497288_b916ec820e_z.jpg,481,640,3,1,0.353247821,212,191,44.07484407,29.84375,239,430,41,253
person,yolov8x,892497288_b916ec820e_z.jpg,481,640,3,1,0.268109292,43,60,8.93970894,9.375,12,72,41,84
person,yolov8x,2767937261_724bce0179_z.jpg,480,640,3,1,0.966789126,400,305,83.33333333,47.65625,200,505,79,479
person,yolov8x,16104664631_cce4a9a58c_z.jpg,480,620,3,1,0.799552381,421,440,87.70833333,70.96774194,1,441,53,474
person,yolov8x,16104664631_cce4a9a58c_z.jpg,480,620,3,1,0.421011627,83,63,17.29166667,10.16129032,494,557,395,478
person,yolov8x,3954929491_6e95503c3d_z.jpg,420,640,3,1,0.81128931,207,93,49.28571429,14.53125,23,116,211,418
person,yolov8x,3954929491_6e95503c3d_z.jpg,420,640,3,1,0.771779478,198,116,47.14285714,18.125,523,639,220,418
person,yolov8x,3954929491_6e95503c3d_z.jpg,420,640,3,1,0.750110984,195,93,46.42857143,14.53125,107,200,223,418
person,yolov8x,3954929491_6e95503c3d_z.jpg,420,640,3,1,0.723859608,189,100,45,15.625,191,291,229,418
person,yolov8x,3954929491_6e95503c3d_z.jpg,420,640,3,1,0.649157882,192,113,45.71428571,17.65625,428,541,227,419
person,yolov8x,3954929491_6e95503c3d_z.jpg,420,640,3,1,0.617726207,181,115,43.0952381,17.96875,336,451,239,420
person,yolov8x,3954929491_6e95503c3d_z.jpg,420,640,3,1,0.425341666,98,56,23.33333333,8.75,248,304,152,250
person,yolov8x,3954929491_6e95503c3d_z.jpg,420,640,3,1,0.4231067,177,74,42.14285714,11.5625,280,354,241,418
person,yolov8x,3954929491_6e95503c3d_z.jpg,420,640,3,1,0.402256846,111,78,26.42857143,12.1875,292,370,187,298
person,yolov8x,3954929491_6e95503c3d_z.jpg,420,640,3,1,0.387478739,149,67,35.47619048,10.46875,477,544,158,307
person,yolov8x,3954929491_6e95503c3d_z.jpg,420,640,3,1,0.365847111,103,75,24.52380952,11.71875,365,440,194,297
person,yolov8x,3954929491_6e95503c3d_z.jpg,420,640,3,1,0.317765713,116,87,27.61904762,13.59375,212,299,187,303
person,yolov8x,3954929491_6e95503c3d_z.jpg,420,640,3,1,0.304376096,141,65,33.57142857,10.15625,178,243,103,244
person,yolov8x,3954929491_6e95503c3d_z.jpg,420,640,3,1,0.294340789,105,55,25,8.59375,393,448,154,259
person,yolov8x,11983632613_4efcf5f3d3_z.jpg,402,640,3,1,0.954968989,166,403,41.29353234,62.96875,236,639,192,358
person,yolov8x,11983632613_4efcf5f3d3_z.jpg,402,640,3,1,0.910705268,206,76,51.24378109,11.875,18,94,9,215
person,yolov8x,11983632613_4efcf5f3d3_z.jpg,402,640,3,1,0.861423612,119,31,29.60199005,4.84375,128,159,47,166
person,yolov8x,11983632613_4efcf5f3d3_z.jpg,402,640,3,1,0.829128027,107,34,26.61691542,5.3125,344,378,21,128
person,yolov8x,11983632613_4efcf5f3d3_z.jpg,402,640,3,1,0.791293621,120,34,29.85074627,5.3125,81,115,48,168
person,yolov8x,11983632613_4efcf5f3d3_z.jpg,402,640,3,1,0.78016305,77,47,19.15422886,7.34375,297,344,46,123
person,yolov8x,11983632613_4efcf5f3d3_z.jpg,402,640,3,1,0.768199801,125,48,31.09452736,7.5,0,48,49,174
person,yolov8x,11983632613_4efcf5f3d3_z.jpg,402,640,3,1,0.723901331,86,36,21.39303483,5.625,474,510,33,119
person,yolov8x,11983632613_4efcf5f3d3_z.jpg,402,640,3,1,0.485781491,80,23,19.90049751,3.59375,261,284,64,144
person,yolov8x,15625756039_d59f4e16fa_z.jpg,480,640,3,1,0.954175711,350,155,72.91666667,24.21875,24,179,129,479
person,yolov8x,15625756039_d59f4e16fa_z.jpg,480,640,3,1,0.946442127,403,164,83.95833333,25.625,205,369,76,479
person,yolov8x,15625756039_d59f4e16fa_z.jpg,480,640,3,1,0.928704619,354,139,73.75,21.71875,424,563,125,479
person,yolov8x,15625756039_d59f4e16fa_z.jpg,480,640,3,1,0.888433039,397,96,82.70833333,15,361,457,82,479
person,yolov8x,6217890759_2a6a04d1d9_z.jpg,427,640,3,1,0.94510901,305,110,71.42857143,17.1875,457,567,93,398
person,yolov8x,6217890759_2a6a04d1d9_z.jpg,427,640,3,1,0.941074252,310,111,72.59953162,17.34375,60,171,103,413
person,yolov8x,6217890759_2a6a04d1d9_z.jpg,427,640,3,1,0.939110994,318,98,74.47306792,15.3125,308,406,61,379
person,yolov8x,6217890759_2a6a04d1d9_z.jpg,427,640,3,1,0.921063721,280,95,65.57377049,14.84375,151,246,93,373
person,yolov8x,6217890759_2a6a04d1d9_z.jpg,427,640,3,1,0.913677752,301,83,70.49180328,12.96875,234,317,70,371
person,yolov8x,6217890759_2a6a04d1d9_z.jpg,427,640,3,1,0.908818185,288,83,67.44730679,12.96875,387,470,94,382
person,yolov8x,3195432512_d0a96b2967_z.jpg,640,480,3,1,0.827210188,637,479,99.53125,99.79166667,0,479,0,637
person,yolov8x,16789366715_633121f7bb_z.jpg,640,457,3,1,0.963884652,636,391,99.375,85.55798687,65,456,3,639
person,yolov8x,3442716929_7a26250063_z.jpg,640,427,3,1,0.967691839,587,425,91.71875,99.53161593,1,426,52,639
person,yolov8x,5943858783_a2cc450fb3_z.jpg,421,639,3,1,0.941397309,379,170,90.02375297,26.60406886,237,407,38,417
person,yolov8x,5943858783_a2cc450fb3_z.jpg,421,639,3,1,0.924631178,364,153,86.4608076,23.94366197,0,153,51,415
person,yolov8x,5943858783_a2cc450fb3_z.jpg,421,639,3,1,0.891875982,386,157,91.68646081,24.56964006,387,544,32,418
person,yolov8x,5943858783_a2cc450fb3_z.jpg,421,639,3,1,0.807035565,324,145,76.95961995,22.69170579,122,267,93,417
person,yolov8x,5425389979_390e3f3881_z.jpg,456,640,3,1,0.757677794,119,118,26.09649123,18.4375,13,131,292,411
person,yolov8x,5425389979_390e3f3881_z.jpg,456,640,3,1,0.709991634,125,105,27.4122807,16.40625,131,236,274,399
person,yolov8x,5425389979_390e3f3881_z.jpg,456,640,3,1,0.695527911,191,98,41.88596491,15.3125,509,607,178,369
person,yolov8x,5425389979_390e3f3881_z.jpg,456,640,3,1,0.693005919,112,112,24.56140351,17.5,528,640,302,414
person,yolov8x,5425389979_390e3f3881_z.jpg,456,640,3,1,0.631195307,123,96,26.97368421,15,431,527,280,403
person,yolov8x,5425389979_390e3f3881_z.jpg,456,640,3,1,0.629326701,175,95,38.37719298,14.84375,97,192,174,349
person,yolov8x,5425389979_390e3f3881_z.jpg,456,640,3,1,0.62798351,177,93,38.81578947,14.53125,352,445,177,354
person,yolov8x,5425389979_390e3f3881_z.jpg,456,640,3,1,0.622902632,206,94,45.1754386,14.6875,266,360,151,357
person,yolov8x,5425389979_390e3f3881_z.jpg,456,640,3,1,0.613578498,106,94,23.24561404,14.6875,234,328,291,397
person,yolov8x,5425389979_390e3f3881_z.jpg,456,640,3,1,0.595007777,108,105,23.68421053,16.40625,329,434,292,400
person,yolov8x,5425389979_390e3f3881_z.jpg,456,640,3,1,0.588496089,213,81,46.71052632,12.65625,189,270,161,374
person,yolov8x,5425389979_390e3f3881_z.jpg,456,640,3,1,0.545455158,170,93,37.28070175,14.53125,435,528,169,339
person,yolov8x,5425389979_390e3f3881_z.jpg,456,640,3,1,0.480836272,205,102,44.95614035,15.9375,11,113,168,373
person,yolov8x,5425389979_390e3f3881_z.jpg,456,640,3,1,0.369070619,140,75,30.70175439,11.71875,351,426,92,232
person,yolov8x,5425389979_390e3f3881_z.jpg,456,640,3,1,0.357274801,142,79,31.14035088,12.34375,424,503,91,233
person,yolov8x,5425389979_390e3f3881_z.jpg,456,640,3,1,0.273302704,127,74,27.85087719,11.5625,110,184,35,162
person,yolov8x,5425389979_390e3f3881_z.jpg,456,640,3,1,0.255368531,135,70,29.60526316,10.9375,75,145,103,238
person,yolov8x,5387089136_efcdc42456_z.jpg,431,640,3,1,0.943181813,373,98,86.54292343,15.3125,542,640,55,428
person,yolov8x,5387089136_efcdc42456_z.jpg,431,640,3,1,0.93933475,227,98,52.66821346,15.3125,239,337,198,425
person,yolov8x,5387089136_efcdc42456_z.jpg,431,640,3,1,0.937820852,344,94,79.81438515,14.6875,0,94,49,393
person,yolov8x,5387089136_efcdc42456_z.jpg,431,640,3,1,0.935388684,244,98,56.612529,15.3125,494,592,185,429
person,yolov8x,5387089136_efcdc42456_z.jpg,431,640,3,1,0.93070358,231,101,53.5962877,15.78125,402,503,197,428
person,yolov8x,5387089136_efcdc42456_z.jpg,431,640,3,1,0.926749349,263,99,61.02088167,15.46875,83,182,165,428
person,yolov8x,5387089136_efcdc42456_z.jpg,431,640,3,1,0.913144588,243,90,56.38051044,14.0625,331,421,187,430
person,yolov8x,5387089136_efcdc42456_z.jpg,431,640,3,1,0.909161508,229,85,53.13225058,13.28125,171,256,195,424
person,yolov8x,5387089136_efcdc42456_z.jpg,431,640,3,1,0.881696224,177,77,41.06728538,12.03125,79,156,68,245
person,yolov8x,5387089136_efcdc42456_z.jpg,431,640,3,1,0.881371021,147,70,34.10672854,10.9375,516,586,42,189
person,yolov8x,5387089136_efcdc42456_z.jpg,431,640,3,1,0.875757515,85,77,19.72157773,12.03125,298,375,7,92
person,yolov8x,5387089136_efcdc42456_z.jpg,431,640,3,1,0.830967546,59,86,13.68909513,13.4375,360,446,36,95
person,yolov8x,5387089136_efcdc42456_z.jpg,431,640,3,1,0.807673752,124,61,28.77030162,9.53125,131,192,27,151
person,yolov8x,5387089136_efcdc42456_z.jpg,431,640,3,1,0.751811743,65,102,15.0812065,15.9375,229,331,30,95
person,yolov8x,5387089136_efcdc42456_z.jpg,431,640,3,1,0.692044735,66,43,15.31322506,6.71875,49,92,68,134
person,yolov8x,5387089136_efcdc42456_z.jpg,431,640,3,1,0.396527648,79,57,18.32946636,8.90625,480,537,29,108
person,yolov8x,5387089136_efcdc42456_z.jpg,431,640,3,1,0.377215475,80,110,18.56148492,17.1875,428,538,29,109
person,yolov8x,5387089136_efcdc42456_z.jpg,431,640,3,1,0.288025916,64,71,14.84918794,11.09375,229,300,30,94
person,yolov8x,3300269400_c276d7a1a7_z.jpg,469,639,3,1,0.971190214,450,594,95.94882729,92.95774648,30,624,12,462
person,yolov8x,528252616_a57e6257ff_z.jpg,480,640,3,1,0.938255787,329,165,68.54166667,25.78125,0,165,150,479
person,yolov8x,528252616_a57e6257ff_z.jpg,480,640,3,1,0.831755102,450,384,93.75,60,208,592,30,480
person,yolov8x,528252616_a57e6257ff_z.jpg,480,640,3,1,0.684948981,353,218,73.54166667,34.0625,422,640,125,478
person,yolov8x,6723753569_a1d8678cde_z.jpg,640,425,3,1,0.968758285,604,423,94.375,99.52941176,1,424,34,638
person,yolov8x,201365540_d1af73d7cd_z.jpg,640,482,3,1,0.926655889,614,479,95.9375,99.37759336,2,481,24,638
person,yolov8x,15091650494_d8a5f37637_z.jpg,640,427,3,1,0.978475451,580,425,90.625,99.53161593,1,426,57,637
person,yolov8x,2365652301_0de626bd97_z.jpg,498,640,3,1,0.939206779,353,124,70.88353414,19.375,390,514,72,425
person,yolov8x,2365652301_0de626bd97_z.jpg,498,640,3,1,0.909212947,311,150,62.4497992,23.4375,219,369,116,427
person,yolov8x,8960442702_6c931904f0_z.jpg,427,640,3,1,0.952344537,421,228,98.59484778,35.625,266,494,0,421
person,yolov8x,8960442702_6c931904f0_z.jpg,427,640,3,1,0.935052216,421,180,98.59484778,28.125,86,266,1,422
person,yolov8x,5594762666_e157f338f0_z.jpg,425,640,3,1,0.964523435,395,294,92.94117647,45.9375,346,640,24,419
person,yolov8x,5594762666_e157f338f0_z.jpg,425,640,3,1,0.939933956,368,284,86.58823529,44.375,0,284,51,419
person,yolov8x,7192116992_5447de0caa_z.jpg,640,480,3,1,0.968718052,609,478,95.15625,99.58333333,1,479,29,638
person,yolov8x,8562326627_1a68052e58_z.jpg,640,582,3,1,0.587996364,637,579,99.53125,99.48453608,3,582,1,638
person,yolov8x,8562326627_1a68052e58_z.jpg,640,582,3,1,0.255746275,638,331,99.6875,56.87285223,1,332,0,638
person,yolov8x,4380790081_1cbcb573ec_z.jpg,421,640,3,1,0.974009514,375,612,89.0736342,95.625,10,622,40,415
person,yolov8x,15392489891_905432249f_z.jpg,427,640,3,1,0.941764355,244,185,57.14285714,28.90625,338,523,179,423
person,yolov8x,15392489891_905432249f_z.jpg,427,640,3,1,0.935506463,292,189,68.38407494,29.53125,63,252,1,293
person,yolov8x,15392489891_905432249f_z.jpg,427,640,3,1,0.898265421,255,229,59.71896956,35.78125,124,353,160,415
person,yolov8x,15392489891_905432249f_z.jpg,427,640,3,1,0.665695429,56,46,13.1147541,7.1875,242,288,132,188
person,yolov8x,15392489891_905432249f_z.jpg,427,640,3,1,0.589262009,103,115,24.12177986,17.96875,349,464,147,250
person,yolov8x,15392489891_905432249f_z.jpg,427,640,3,1,0.42038846,110,59,25.76112412,9.21875,242,301,132,242
person,yolov8x,15392489891_905432249f_z.jpg,427,640,3,1,0.413604528,103,81,24.12177986,12.65625,349,430,147,250
person,yolov8x,4479906928_4ab0604d1c_z.jpg,640,480,3,1,0.93447727,639,345,99.84375,71.875,38,383,0,639
person,yolov8x,2392419690_8495e2b2c9_z.jpg,496,640,3,1,0.965671301,241,189,48.58870968,29.53125,3,192,252,493
person,yolov8x,2392419690_8495e2b2c9_z.jpg,496,640,3,1,0.964710712,241,258,48.58870968,40.3125,3,261,3,244
person,yolov8x,2392419690_8495e2b2c9_z.jpg,496,640,3,1,0.96209538,242,197,48.79032258,30.78125,323,520,2,244
person,yolov8x,2392419690_8495e2b2c9_z.jpg,496,640,3,1,0.893958569,172,217,34.67741935,33.90625,420,637,322,494
person,yolov8x,2392419690_8495e2b2c9_z.jpg,496,640,3,1,0.867702246,78,61,15.72580645,9.53125,16,77,251,329
person,yolov8x,2392419690_8495e2b2c9_z.jpg,496,640,3,1,0.867005169,134,180,27.01612903,28.125,420,600,111,245
person,yolov8x,2392419690_8495e2b2c9_z.jpg,496,640,3,1,0.785772502,239,166,48.18548387,25.9375,323,489,251,490
person,yolov8x,2392419690_8495e2b2c9_z.jpg,496,640,3,1,0.576107442,111,162,22.37903226,25.3125,94,256,383,494
person,yolov8x,8538565946_199e28b584_z.jpg,612,612,3,1,0.946756184,600,517,98.03921569,84.47712418,66,583,11,611
person,yolov8x,15083791924_c7195faca3_z.jpg,428,640,3,1,0.963961303,422,399,98.59813084,62.34375,51,450,1,423
person,yolov8x,8922688952_9cacbffe29_z.jpg,639,402,3,1,0.824785769,629,401,98.43505477,99.75124378,0,401,9,638
person,yolov8x,8922688952_9cacbffe29_z.jpg,639,402,3,1,0.764513254,636,263,99.53051643,65.42288557,0,263,0,636
person,yolov8x,5540859766_5596c9c59e_z.jpg,520,600,3,1,0.970368326,483,574,92.88461538,95.66666667,1,575,30,513
person,yolov8x,5826499075_8c91ec270b_z.jpg,640,478,3,1,0.954102457,575,360,89.84375,75.31380753,60,420,65,640
person,yolov8x,4728907141_f9e5aa4bce_z.jpg,480,640,3,1,0.944825411,323,207,67.29166667,32.34375,185,392,59,382
person,yolov8x,4728907141_f9e5aa4bce_z.jpg,480,640,3,1,0.918834209,183,106,38.125,16.5625,0,106,22,205
person,yolov8x,4728907141_f9e5aa4bce_z.jpg,480,640,3,1,0.89314574,178,95,37.08333333,14.84375,493,588,17,195
person,yolov8x,5316877862_ccdebd50e5_z.jpg,419,639,3,1,0.957575917,364,353,86.87350835,55.24256651,285,638,52,416
person,yolov8x,5316877862_ccdebd50e5_z.jpg,419,639,3,1,0.938958347,382,228,91.16945107,35.68075117,12,240,33,415
person,yolov8x,5316877862_ccdebd50e5_z.jpg,419,639,3,1,0.887652099,409,89,97.61336516,13.92801252,0,89,1,410
person,yolov8x,5316877862_ccdebd50e5_z.jpg,419,639,3,1,0.771631241,55,50,13.12649165,7.824726135,298,348,364,419
person,yolov8x,5316877862_ccdebd50e5_z.jpg,419,639,3,1,0.611517906,73,26,17.42243437,4.06885759,76,102,38,111
person,yolov8x,5316877862_ccdebd50e5_z.jpg,419,639,3,1,0.570547998,234,35,55.84725537,5.477308294,242,277,183,417
person,yolov8x,5316877862_ccdebd50e5_z.jpg,419,639,3,1,0.391169012,263,69,62.76849642,10.79812207,191,260,97,360
person,yolov8x,5316877862_ccdebd50e5_z.jpg,419,639,3,1,0.29058972,39,26,9.307875895,4.06885759,279,305,380,419
person,yolov8x,5316877862_ccdebd50e5_z.jpg,419,639,3,1,0.273038894,94,68,22.43436754,10.64162754,193,261,266,360
person,yolov8x,15543230406_71c5a59208_z.jpg,463,640,3,1,0.946020067,434,284,93.73650108,44.375,0,284,23,457
person,yolov8x,15543230406_71c5a59208_z.jpg,463,640,3,1,0.904771686,365,411,78.8336933,64.21875,226,637,92,457
person,yolov8x,15543230406_71c5a59208_z.jpg,463,640,3,1,0.895517588,365,245,78.8336933,38.28125,226,471,92,457
person,yolov8x,6431185703_6c72dd7b5e_z.jpg,427,640,3,1,0.758862734,135,48,31.61592506,7.5,211,259,185,320
person,yolov8x,6431185703_6c72dd7b5e_z.jpg,427,640,3,1,0.742347836,152,55,35.5971897,8.59375,292,347,188,340
person,yolov8x,6431185703_6c72dd7b5e_z.jpg,427,640,3,1,0.671629786,118,38,27.63466042,5.9375,156,194,189,307
person,yolov8x,6431185703_6c72dd7b5e_z.jpg,427,640,3,1,0.636671305,158,72,37.00234192,11.25,344,416,197,355
person,yolov8x,6431185703_6c72dd7b5e_z.jpg,427,640,3,1,0.627721727,100,36,23.41920375,5.625,87,123,191,291
person,yolov8x,6431185703_6c72dd7b5e_z.jpg,427,640,3,1,0.577747226,112,40,26.2295082,6.25,117,157,189,301
person,yolov8x,6431185703_6c72dd7b5e_z.jpg,427,640,3,1,0.471117884,148,68,34.66042155,10.625,470,538,171,319
person,yolov8x,6431185703_6c72dd7b5e_z.jpg,427,640,3,1,0.468134254,104,32,24.3559719,5,185,217,185,289
person,yolov8x,6431185703_6c72dd7b5e_z.jpg,427,640,3,1,0.340634108,93,28,21.77985948,4.375,62,90,193,286
person,yolov8x,6431185703_6c72dd7b5e_z.jpg,427,640,3,1,0.323075444,97,31,22.71662763,4.84375,249,280,184,281
person,yolov8x,6431185703_6c72dd7b5e_z.jpg,427,640,3,1,0.294491976,122,65,28.57142857,10.15625,429,494,215,337
person,yolov8x,6431185703_6c72dd7b5e_z.jpg,427,640,3,1,0.271593809,90,45,21.07728337,7.03125,591,636,174,264
person,yolov8x,6431185703_6c72dd7b5e_z.jpg,427,640,3,1,0.267009854,132,78,30.91334895,12.1875,551,629,170,302
person,yolov8x,6431185703_6c72dd7b5e_z.jpg,427,640,3,1,0.26416716,102,60,23.88758782,9.375,551,611,200,302